Player,Nation,Pos,Squad,Age,Born,90s,Tkl,TklW,Def 3rd,Mid 3rd,Att 3rd,Tkl,Att,Tkl%,Lost,Blocks,Sh,Pass,Int,Tkl+Int,Clr,Err,season
Max Aarons,eng ENG,DF,Norwich City,21,2000,32,64,44,49,15,0,37,55,67.3,18,39,19,20,28,92,96,1,21/22
Che Adams,sct SCO,FW,Southampton,25,1996,22.7,13,6,5,5,3,2,16,12.5,14,18,2,16,8,21,18,0,21/22
Rayan Aït Nouri,dz ALG,DFMF,Wolves,20,2001,20.3,64,36,46,15,3,22,44,50,22,24,2,22,22,86,39,1,21/22
Kristoffer Ajer,no NOR,DF,Brentford,23,1998,22.2,29,18,21,6,2,13,21,61.9,8,19,11,8,26,55,74,0,21/22
Nathan Aké,nl NED,DF,Manchester City,26,1995,10.3,16,9,7,8,1,6,8,75,2,7,5,2,8,24,23,0,21/22
Marc Albrighton,eng ENG,FWDF,Leicester City,31,1989,12.6,31,19,16,9,6,10,47,21.3,37,15,3,12,14,45,20,0,21/22
Thiago Alcántara,es ESP,MF,Liverpool,30,1991,17,48,29,14,24,10,10,42,23.8,32,22,2,20,26,74,13,2,21/22
Trent Alexander-Arnold,eng ENG,DF,Liverpool,22,1998,31.7,40,23,19,13,8,27,60,45,33,22,4,18,43,83,40,0,21/22
Alisson,br BRA,GK,Liverpool,28,1992,36,3,1,3,0,0,3,5,60,2,1,0,1,0,3,28,1,21/22
Allan,br BRA,MF,Everton,30,1991,24.3,74,44,28,39,7,34,105,32.4,71,40,9,31,23,97,39,1,21/22
Dele Alli,eng ENG,MF,Tottenham,25,1996,7.3,14,8,10,3,1,5,17,29.4,12,22,5,17,6,20,16,0,21/22
Dele Alli,eng ENG,MFFW,Everton,25,1996,3.8,7,2,3,4,0,0,4,0,4,7,2,5,6,13,10,0,21/22
Miguel Almirón,py PAR,MFFW,Newcastle Utd,27,1994,19.1,47,29,23,17,7,11,44,25,33,14,1,13,20,67,13,0,21/22
Marcos Alonso,es ESP,DF,Chelsea,30,1990,24.1,41,29,20,12,9,17,36,47.2,19,29,5,24,43,84,53,0,21/22
Steven Alzate,co COL,MF,Brighton,22,1998,4.5,10,4,4,5,1,4,7,57.1,3,2,1,1,10,20,10,0,21/22
Daniel Amartey,gh GHA,DF,Leicester City,26,1994,23.6,26,13,19,7,0,19,29,65.5,10,30,22,8,21,47,93,4,21/22
Joachim Andersen,dk DEN,DF,Crystal Palace,25,1996,32.4,30,23,21,9,0,16,27,59.3,11,29,19,10,37,67,125,3,21/22
Michail Antonio,jm JAM,FW,West Ham,31,1990,33,23,17,5,9,9,7,18,38.9,11,19,1,18,3,26,13,0,21/22
Cameron Archer,eng ENG,FWMF,Aston Villa,20,2001,0.3,0,0,0,0,0,0,0,,0,0,0,0,0,0,0,0,21/22
Alphonse Areola,fr FRA,GK,West Ham,28,1993,1,0,0,0,0,0,0,0,,0,0,0,0,0,0,1,0,21/22
Adam Armstrong,eng ENG,FW,Southampton,24,1997,15.7,10,4,2,2,6,0,6,0,6,13,1,12,3,13,6,0,21/22
Stuart Armstrong,sct SCO,MF,Southampton,29,1992,16.4,27,19,15,6,6,9,23,39.1,14,10,1,9,8,35,15,0,21/22
Kepa Arrizabalaga,es ESP,GK,Chelsea,26,1994,4,0,0,0,0,0,0,0,,0,0,0,0,0,0,4,0,21/22
Harrison Ashby,sct SCO,DF,West Ham,19,2001,0.1,0,0,0,0,0,0,0,,0,1,0,1,1,1,1,0,21/22
Pierre-Emerick Aubameyang,ga GAB,FW,Arsenal,32,1989,11.5,11,5,6,4,1,3,10,30,7,12,1,11,0,11,4,0,21/22
Jordan Ayew,gh GHA,FW,Crystal Palace,29,1991,22.4,47,30,20,20,7,17,31,54.8,14,33,3,30,15,62,15,0,21/22
Luke Ayling,eng ENG,DF,Leeds United,29,1991,25.2,74,42,46,23,5,51,97,52.6,46,46,25,21,28,102,52,1,21/22
César Azpilicueta,es ESP,DF,Chelsea,31,1989,23,51,28,18,27,6,16,35,45.7,19,32,9,23,23,74,65,1,21/22
Daniel Bachmann,at AUT,GK,Watford,27,1994,12,0,0,0,0,0,0,0,,0,0,0,0,1,1,5,0,21/22
Leon Bailey,jm JAM,FWMF,Aston Villa,23,1997,8.5,17,11,6,8,3,6,13,46.2,7,10,1,9,1,18,2,0,21/22
Eric Bailly,ci CIV,DF,Manchester Utd,27,1994,2.4,5,4,4,0,1,3,4,75,1,4,2,2,3,8,11,0,21/22
Folarin Balogun,eng ENG,FW,Arsenal,20,2001,0.8,1,1,0,0,1,0,0,,0,1,0,1,0,1,1,0,21/22
Patrick Bamford,eng ENG,FW,Leeds United,27,1993,6.2,1,0,0,1,0,0,3,0,3,8,2,6,2,3,8,0,21/22
Shandon Baptiste,gd GRN,MF,Brentford,23,1998,10.1,14,4,9,4,1,6,15,40,9,10,0,10,11,25,12,0,21/22
Ross Barkley,eng ENG,MFFW,Chelsea,27,1993,2,0,0,0,0,0,0,1,0,1,1,0,1,1,1,0,0,21/22
Ashley Barnes,eng ENG,FW,Burnley,31,1989,9,11,2,2,7,2,2,9,22.2,7,8,1,7,2,13,5,0,21/22
Harvey Barnes,eng ENG,FWMF,Leicester City,23,1997,23.3,31,16,9,11,11,7,23,30.4,16,24,1,23,5,36,7,0,21/22
Lewis Bate,eng ENG,MF,Leeds United,18,2002,1.6,1,0,0,0,1,0,8,0,8,1,0,1,1,2,1,0,21/22
Mads Bech Sørensen,dk DEN,DF,Brentford,22,1999,9.3,8,7,6,2,0,6,7,85.7,1,9,6,3,6,14,25,0,21/22
Jan Bednarek,pl POL,DF,Southampton,25,1996,29.2,32,15,18,13,1,19,33,57.6,14,48,27,21,72,104,141,0,21/22
Donny van de Beek,nl NED,MF,Manchester Utd,24,1997,0.8,6,4,4,1,1,1,2,50,1,5,1,4,2,8,1,0,21/22
Donny van de Beek,nl NED,MF,Everton,24,1997,5.4,15,7,8,6,1,6,13,46.2,7,6,2,4,6,21,4,0,21/22
Asmir Begović,ba BIH,GK,Everton,34,1987,3,0,0,0,0,0,0,0,,0,0,0,0,0,0,3,0,21/22
Saïd Benrahma,dz ALG,FWMF,West Ham,25,1995,24.1,28,17,16,9,3,15,38,39.5,23,17,1,16,9,37,8,0,21/22
Rodrigo Bentancur,uy URU,MF,Tottenham,24,1997,15.1,36,18,14,14,8,16,32,50,16,24,9,15,20,56,35,0,21/22
Christian Benteke,be BEL,FW,Crystal Palace,30,1990,12.7,3,2,1,2,0,2,6,33.3,4,7,3,4,2,5,33,0,21/22
Jóhann Berg Guðmundsson,is ISL,MF,Burnley,30,1990,12.2,16,6,7,7,2,5,20,25,15,11,2,9,12,28,22,0,21/22
Steven Bergwijn,nl NED,FWMF,Tottenham,23,1997,6.3,3,2,2,1,0,1,10,10,9,3,0,3,1,4,8,0,21/22
Ryan Bertrand,eng ENG,DF,Leicester City,31,1989,3.7,8,5,3,4,1,2,5,40,3,8,3,5,1,9,7,0,21/22
Mads Bidstrup,dk DEN,MF,Brentford,20,2001,0.5,1,0,0,1,0,0,3,0,3,0,0,0,1,2,2,0,21/22
Yves Bissouma,ml MLI,MF,Brighton,24,1996,23.5,76,49,35,37,4,21,37,56.8,16,33,3,30,50,126,49,0,21/22
Willy Boly,ci CIV,DF,Wolves,30,1991,10,25,19,18,7,0,8,15,53.3,7,14,6,8,14,39,35,0,21/22
Jarrod Bowen,eng ENG,FW,West Ham,24,1996,33.1,36,20,20,11,5,17,44,38.6,27,29,2,27,21,57,14,0,21/22
Jarrad Branthwaite,eng ENG,DF,Everton,19,2002,4.3,4,1,3,1,0,3,8,37.5,5,3,2,1,1,5,20,0,21/22
Armando Broja,al ALB,FW,Southampton,19,2001,21.9,12,5,2,7,3,2,9,22.2,7,17,1,16,3,15,11,0,21/22
Josh Brownhill,eng ENG,MF,Burnley,25,1995,32.8,73,37,25,42,6,21,53,39.6,32,37,12,25,68,141,42,1,21/22
Lewis Brunt,eng ENG,MF,Leicester City,20,2000,0.3,0,0,0,0,0,0,0,,0,1,0,1,0,0,0,0,21/22
Bryan,es ESP,FWMF,Tottenham,20,2001,1,3,0,1,0,2,1,2,50,1,2,0,2,0,3,0,0,21/22
Emi Buendía,ar ARG,MFFW,Aston Villa,24,1996,21.1,38,18,16,13,9,21,51,41.2,30,21,3,18,9,47,11,0,21/22
Dan Burn,eng ENG,DF,Newcastle Utd,29,1992,16,16,11,11,4,1,7,11,63.6,4,22,14,8,20,36,101,0,21/22
Dan Burn,eng ENG,DF,Brighton,29,1992,11.4,22,12,13,8,1,6,15,40,9,14,10,4,24,46,51,0,21/22
Jack Butland,eng ENG,GK,Crystal Palace,28,1993,8.5,0,0,0,0,0,0,0,,0,0,0,0,0,0,1,0,21/22
Sam Byram,eng ENG,DF,Norwich City,27,1993,11.4,24,15,17,6,1,19,27,70.4,8,21,11,10,22,46,48,0,21/22
Willy Caballero,ar ARG,GK,Southampton,39,1981,2,0,0,0,0,0,0,0,,0,0,0,0,0,0,2,1,21/22
Moisés Caicedo,ec ECU,MF,Brighton,19,2001,7.3,16,10,7,7,2,5,12,41.7,7,18,4,14,10,26,7,0,21/22
Dominic Calvert-Lewin,eng ENG,FW,Everton,24,1997,14.3,11,8,1,6,4,3,8,37.5,5,5,2,3,3,14,12,0,21/22
Chem Campbell,wls WAL,MF,Wolves,18,2002,0.1,1,1,0,1,0,0,0,,0,0,0,0,0,1,0,0,21/22
João Cancelo,pt POR,DF,Manchester City,27,1994,35.9,83,54,33,35,15,46,91,50.5,45,25,3,22,59,142,45,1,21/22
Sergi Canós,es ESP,DFFW,Brentford,24,1997,23.1,56,25,32,15,9,33,60,55,27,32,3,29,22,78,38,0,21/22
Todd Cantwell,eng ENG,FWMF,Norwich City,23,1998,4.9,15,13,8,6,1,6,17,35.3,11,2,0,2,3,18,2,0,21/22
Matty Cash,pl POL,DF,Aston Villa,23,1997,37.5,89,50,52,34,3,47,78,60.3,31,54,16,38,49,138,100,2,21/22
Timothy Castagne,be BEL,DF,Leicester City,25,1995,23.6,67,31,38,22,7,27,43,62.8,16,28,9,19,29,96,54,1,21/22
Jonny Castro,es ESP,DF,Wolves,27,1994,11.4,25,15,13,11,1,11,20,55,9,14,3,11,13,38,11,0,21/22
Craig Cathcart,nir NIR,DF,Watford,32,1989,26.6,32,15,25,6,1,16,30,53.3,14,39,29,10,28,60,132,3,21/22
Edinson Cavani,uy URU,FW,Manchester Utd,34,1987,8.5,4,1,0,3,1,2,8,25,6,6,0,6,2,6,8,0,21/22
Kayky Chagas,br BRA,FW,Manchester City,18,2003,0.1,0,0,0,0,0,0,0,,0,0,0,0,0,0,0,0,21/22
Trevoh Chalobah,eng ENG,DF,Chelsea,22,1999,16.1,40,27,22,18,0,24,31,77.4,7,16,6,10,19,59,43,2,21/22
Calum Chambers,eng ENG,DF,Arsenal,26,1995,1.9,5,3,3,1,1,3,4,75,1,6,3,3,0,5,10,0,21/22
Calum Chambers,eng ENG,DF,Aston Villa,26,1995,9.2,16,8,10,6,0,4,6,66.7,2,14,8,6,5,21,42,0,21/22
Daniel Chesters,eng ENG,MF,West Ham,19,2002,0,0,0,0,0,0,0,0,,0,0,0,0,0,0,0,0,21/22
Ben Chilwell,eng ENG,DF,Chelsea,24,1996,6,8,3,2,6,0,2,5,40,3,7,0,7,4,12,14,1,21/22
Chiquinho,pt POR,DFFW,Wolves,21,2000,2.3,9,6,4,5,0,4,5,80,1,5,0,5,2,11,1,0,21/22
Hamza Choudhury,eng ENG,DFMF,Leicester City,23,1997,3.2,9,3,4,4,1,3,5,60,2,0,0,0,12,21,10,0,21/22
Andreas Christensen,dk DEN,DF,Chelsea,25,1996,16.6,14,8,9,4,1,4,7,57.1,3,14,6,8,29,43,57,1,21/22
Carney Chukwuemeka,eng ENG,MFFW,Aston Villa,17,2003,3.3,7,1,2,5,0,3,5,60,2,3,0,3,1,8,2,1,21/22
Ciaran Clark,ie IRL,DF,Newcastle Utd,31,1989,11.3,13,10,4,7,2,9,14,64.3,5,14,11,3,13,26,43,1,21/22
Tom Cleverley,eng ENG,MF,Watford,31,1989,18,37,20,19,17,1,18,33,54.5,15,23,6,17,18,55,19,3,21/22
Nathaniel Clyne,eng ENG,DF,Crystal Palace,30,1991,15,21,10,11,9,1,10,20,50,10,7,2,5,15,36,32,0,21/22
Conor Coady,eng ENG,DF,Wolves,28,1993,37.3,31,14,23,7,1,16,28,57.1,12,46,40,6,28,59,140,0,21/22
Séamus Coleman,ie IRL,DF,Everton,32,1988,29.5,61,36,35,16,10,33,51,64.7,18,30,11,19,32,93,80,2,21/22
Nathan Collins,ie IRL,DF,Burnley,20,2001,18.6,37,15,27,8,2,17,27,63,10,38,25,13,24,61,83,2,21/22
Aaron Connolly,ie IRL,FWMF,Brighton,21,2000,1.7,0,0,0,0,0,0,1,0,1,2,0,2,0,0,0,0,21/22
Liam Cooper,sct SCO,DF,Leeds United,29,1991,20.2,41,23,27,13,1,23,33,69.7,10,29,18,11,43,84,72,2,21/22
Jack Cork,eng ENG,MF,Burnley,32,1989,18.6,20,6,6,11,3,7,20,35,13,17,4,13,17,37,29,1,21/22
Maxwel Cornet,ci CIV,FWMF,Burnley,24,1996,19.6,16,9,7,5,4,7,15,46.7,8,13,4,9,10,26,14,0,21/22
Hélder Costa,ao ANG,MF,Leeds United,27,1994,0.2,0,0,0,0,0,0,0,,0,1,0,1,0,0,0,0,21/22
Vladimír Coufal,cz CZE,DF,West Ham,28,1992,24.5,45,25,24,14,7,18,36,50,18,31,9,22,22,67,64,1,21/22
Philippe Coutinho,br BRA,MFFW,Aston Villa,29,1992,14.8,17,12,4,11,2,6,21,28.6,15,11,1,10,7,24,4,0,21/22
Aaron Cresswell,eng ENG,DF,West Ham,31,1989,30.3,28,18,18,6,4,13,25,52,12,31,18,13,35,63,66,0,21/22
Charlie Cresswell,eng ENG,DF,Leeds United,18,2002,1.6,5,2,1,4,0,3,3,100,0,1,1,0,2,7,6,0,21/22
Cucho,co COL,FWMF,Watford,22,1999,12.7,13,5,5,5,3,5,27,18.5,22,13,1,12,5,18,9,0,21/22
Marc Cucurella,es ESP,DF,Brighton,23,1998,34.3,93,62,43,32,18,44,71,62,27,42,14,28,30,123,74,0,21/22
Luke Cundle,eng ENG,MF,Wolves,19,2002,2,4,3,0,4,0,1,1,100,0,0,0,0,1,5,1,0,21/22
Patson Daka,zm ZAM,FW,Leicester City,22,1998,12.9,15,10,2,8,5,2,19,10.5,17,7,0,7,2,17,8,0,21/22
Stuart Dallas,nir NIR,DFMF,Leeds United,30,1991,32.4,93,55,58,31,4,56,105,53.3,49,45,14,31,57,150,63,2,21/22
Diogo Dalot,pt POR,DF,Manchester Utd,22,1999,20,55,41,35,12,8,31,57,54.4,26,24,13,11,29,84,59,0,21/22
Karl Darlow,eng ENG,GK,Newcastle Utd,30,1990,8,0,0,0,0,0,0,0,,0,0,0,0,0,0,5,1,21/22
Josh Dasilva,eng ENG,MFFW,Brentford,22,1998,2.9,2,1,0,1,1,1,2,50,1,3,0,3,1,3,7,0,21/22
Ben Davies,wls WAL,DF,Tottenham,28,1993,28.2,36,21,20,12,4,13,26,50,13,32,19,13,30,66,75,1,21/22
Tom Davies,eng ENG,MF,Everton,23,1998,2.6,3,1,1,1,1,2,5,40,3,2,1,1,2,5,9,0,21/22
Keinan Davis,eng ENG,FW,Aston Villa,23,1998,0.1,0,0,0,0,0,0,0,,0,0,0,0,0,0,0,0,21/22
Craig Dawson,eng ENG,DF,West Ham,31,1990,30.6,29,17,20,8,1,14,25,56,11,59,52,7,29,58,139,0,21/22
Kevin De Bruyne,be BEL,MF,Manchester City,30,1991,24.5,32,16,4,15,13,12,37,32.4,25,32,2,30,6,38,16,0,21/22
Troy Deeney,eng ENG,FW,Watford,33,1988,0.3,0,0,0,0,0,0,1,0,1,0,0,0,0,0,2,0,21/22
Liam Delap,eng ENG,FW,Manchester City,18,2003,0.1,0,0,0,0,0,0,0,,0,0,0,0,0,0,0,0,21/22
Fabian Delph,eng ENG,MF,Everton,31,1989,7.4,18,15,10,7,1,8,21,38.1,13,12,5,7,14,32,10,0,21/22
Leander Dendoncker,be BEL,MF,Wolves,26,1995,21.7,42,17,25,14,3,22,50,44,28,37,10,27,9,51,38,1,21/22
Emmanuel Dennis,ng NGA,FWMF,Watford,23,1997,28.7,51,35,20,22,9,17,52,32.7,35,36,2,34,15,66,13,0,21/22
Kiernan Dewsbury-Hall,eng ENG,MF,Leicester City,22,1998,23.4,39,24,20,14,5,19,40,47.5,21,37,8,29,21,60,26,1,21/22
Ibrahima Diallo,fr FRA,MF,Southampton,22,1999,11.4,22,11,10,9,3,10,24,41.7,14,7,0,7,9,31,10,0,21/22
Rúben Dias,pt POR,DF,Manchester City,24,1997,26.7,26,19,11,12,3,8,15,53.3,7,19,13,6,23,49,66,0,21/22
Luis Díaz,co COL,FW,Liverpool,24,1997,10.6,9,7,3,5,1,2,8,25,6,7,0,7,4,13,2,0,21/22
Eric Dier,eng ENG,DF,Tottenham,27,1994,34.1,15,9,6,8,1,7,14,50,7,37,32,5,27,42,142,1,21/22
Lucas Digne,fr FRA,DF,Aston Villa,28,1993,14.1,13,10,8,3,2,9,19,47.4,10,15,8,7,23,36,40,0,21/22
Lucas Digne,fr FRA,DF,Everton,28,1993,13,33,19,26,4,3,21,28,75,7,16,5,11,14,47,30,0,21/22
Issa Diop,fr FRA,DF,West Ham,24,1997,10.7,10,8,5,5,0,4,11,36.4,7,14,13,1,7,17,44,0,21/22
Moussa Djenepo,ml MLI,MF,Southampton,23,1998,5.1,9,3,3,5,1,3,11,27.3,8,6,1,5,2,11,6,1,21/22
Lewis Dobbin,eng ENG,FWMF,Everton,18,2003,0.4,2,1,0,1,1,1,2,50,1,0,0,0,0,2,0,0,21/22
Matt Doherty,ie IRL,DF,Tottenham,29,1992,9.7,18,12,5,11,2,8,14,57.1,6,11,2,9,13,31,20,0,21/22
Gabriel Dos Santos,br BRA,DF,Arsenal,23,1997,34,50,30,36,12,2,30,41,73.2,11,34,26,8,13,63,112,4,21/22
Abdoulaye Doucouré,ml MLI,MF,Everton,28,1993,28.2,75,43,30,37,8,32,71,45.1,39,33,8,25,28,103,32,0,21/22
Kieran Dowell,eng ENG,FWMF,Norwich City,23,1997,10.1,18,7,8,7,3,9,32,28.1,23,10,1,9,7,25,4,0,21/22
Cody Drameh,eng ENG,DFMF,Leeds United,19,2001,1.4,4,2,3,1,0,1,3,33.3,2,0,0,0,1,5,4,0,21/22
Martin Dúbravka,sk SVK,GK,Newcastle Utd,32,1989,26,1,1,1,0,0,0,1,0,1,0,0,0,0,1,8,2,21/22
Shane Duffy,ie IRL,DF,Brighton,29,1992,16,15,12,12,3,0,8,14,57.1,6,24,18,6,16,31,76,1,21/22
Paul Dummett,wls WAL,DF,Newcastle Utd,29,1991,2.2,7,3,3,4,0,5,8,62.5,3,5,0,5,3,10,5,0,21/22
Lewis Dunk,eng ENG,DF,Brighton,29,1991,28.6,10,8,5,5,0,5,11,45.5,6,32,28,4,27,37,113,3,21/22
Ederson,br BRA,GK,Manchester City,27,1993,37,2,1,2,0,0,0,2,0,2,0,0,0,0,2,12,0,21/22
Odsonne Édouard,fr FRA,FW,Crystal Palace,23,1998,17.4,16,10,2,7,7,7,21,33.3,14,20,5,15,0,16,18,0,21/22
CJ Egan-Riley,eng ENG,DF,Manchester City,18,2003,0,1,1,1,0,0,1,1,100,0,0,0,0,0,1,0,0,21/22
Anthony Elanga,se SWE,FW,Manchester Utd,19,2002,13.5,26,20,12,12,2,15,29,51.7,14,17,1,16,9,35,7,0,21/22
Harvey Elliott,eng ENG,MF,Liverpool,18,2003,3.8,3,0,1,1,1,0,6,0,6,8,1,7,4,7,2,0,21/22
Mohamed Elneny,eg EGY,MF,Arsenal,29,1992,9,16,8,10,5,1,7,12,58.3,5,7,1,6,14,30,13,0,21/22
Mohamed Elyounoussi,no NOR,MFFW,Southampton,26,1994,22.7,36,17,14,15,7,11,39,28.2,28,23,2,21,12,48,28,0,21/22
Emerson,br BRA,DFMF,Tottenham,22,1999,25.4,72,47,50,16,6,36,67,53.7,31,25,2,23,22,94,92,1,21/22
Christian Eriksen,dk DEN,MF,Brentford,29,1992,10.4,13,6,4,5,4,8,17,47.1,9,9,1,8,9,22,14,0,21/22
Oghenekaro Etebo,ng NGA,MF,Watford,25,1995,4.5,11,8,7,4,0,3,8,37.5,5,3,1,2,5,16,5,0,21/22
Jonny Evans,nir NIR,DF,Leicester City,33,1988,15,24,14,14,8,2,14,22,63.6,8,17,13,4,20,44,59,0,21/22
Eberechi Eze,eng ENG,MFFW,Crystal Palace,23,1998,6.7,10,6,5,2,3,6,11,54.5,5,4,1,3,5,15,1,0,21/22
Łukasz Fabiański,pl POL,GK,West Ham,36,1985,37,0,0,0,0,0,0,0,,0,0,0,0,0,0,11,0,21/22
Fabinho,br BRA,MF,Liverpool,27,1993,25.7,46,25,17,23,6,24,70,34.3,46,33,10,23,39,85,25,1,21/22
Kiko Femenía,es ESP,DF,Watford,30,1991,23.8,35,22,23,10,2,21,37,56.8,16,24,8,16,37,72,51,0,21/22
Evan Ferguson,ie IRL,MF,Brighton,16,2004,0.3,0,0,0,0,0,0,0,,0,0,0,0,0,0,0,0,21/22
Nathan Ferguson,eng ENG,DF,Crystal Palace,20,2000,0.1,0,0,0,0,0,0,0,,0,0,0,0,0,0,0,0,21/22
Bruno Fernandes,pt POR,MF,Manchester Utd,26,1994,34.6,54,28,26,22,6,26,91,28.6,65,36,0,36,17,71,42,2,21/22
Álvaro Fernández,es ESP,GK,Brentford,23,1998,12,0,0,0,0,0,0,0,,0,0,0,0,0,0,5,2,21/22
Federico Fernández,ar ARG,DF,Newcastle Utd,32,1989,5.8,3,0,3,0,0,2,5,40,3,10,10,0,4,7,28,0,21/22
Fernandinho,br BRA,MFDF,Manchester City,36,1985,10.7,21,10,7,10,4,9,27,33.3,18,8,2,6,8,29,13,1,21/22
Roberto Firmino,br BRA,FW,Liverpool,29,1991,11,23,14,5,8,10,3,16,18.8,13,20,0,20,4,27,3,0,21/22
Junior Firpo,es ESP,DFMF,Leeds United,24,1996,19,61,29,30,26,5,31,59,52.5,28,22,6,16,24,85,37,0,21/22
Ashley Fletcher,eng ENG,FW,Watford,25,1995,0.3,2,1,1,1,0,1,1,100,0,1,1,0,0,2,0,0,21/22
Phil Foden,eng ENG,FW,Manchester City,21,2000,23.6,16,8,10,4,2,7,17,41.2,10,9,0,9,11,27,5,0,21/22
Wesley Fofana,fr FRA,DF,Leicester City,20,2000,7,12,8,11,1,0,7,11,63.6,4,5,2,3,12,24,26,1,21/22
Pablo Fornals,es ESP,FWMF,West Ham,25,1996,31.1,54,28,21,21,12,22,84,26.2,62,49,2,47,27,81,16,1,21/22
Adam Forshaw,eng ENG,MF,Leeds United,29,1991,17,53,23,21,27,5,21,54,38.9,33,17,1,16,19,72,12,2,21/22
Marcus Forss,fi FIN,FWMF,Brentford,22,1999,2.3,3,3,0,2,1,2,4,50,2,5,0,5,1,4,0,0,21/22
Fraser Forster,eng ENG,GK,Southampton,33,1988,19,1,0,1,0,0,0,1,0,1,0,0,0,0,1,23,2,21/22
Ben Foster,eng ENG,GK,Watford,38,1983,26,0,0,0,0,0,0,3,0,3,0,0,0,0,0,9,4,21/22
Tariqe Fosu,gh GHA,DF,Brentford,25,1995,0.2,0,0,0,0,0,0,0,,0,1,0,1,0,0,0,0,21/22
Ryan Fraser,sct SCO,FWMF,Newcastle Utd,27,1994,16.3,10,3,5,3,2,5,13,38.5,8,11,1,10,11,21,11,0,21/22
Fred,br BRA,MF,Manchester Utd,28,1993,22.5,63,27,32,24,7,22,79,27.8,57,38,11,27,32,95,24,0,21/22
Ryan Fredericks,eng ENG,DF,West Ham,28,1992,3.4,2,2,2,0,0,0,1,0,1,2,1,1,4,6,6,0,21/22
Leo Fuhr Hjelde,no NOR,MFDF,Leeds United,17,2003,1.7,5,4,3,2,0,3,3,100,0,3,3,0,4,9,7,0,21/22
Conor Gallagher,eng ENG,MF,Crystal Palace,21,2000,31.6,69,38,35,20,14,21,69,30.4,48,58,9,49,29,98,26,0,21/22
Alejandro Garnacho,es ESP,FWMF,Manchester Utd,17,2004,0.1,0,0,0,0,0,0,1,0,1,0,0,0,0,0,0,0,21/22
Dwight Gayle,eng ENG,FWDF,Newcastle Utd,30,1990,0.4,1,0,0,1,0,0,1,0,1,0,0,0,1,2,0,0,21/22
Jean-Philippe Gbamin,ci CIV,MF,Everton,25,1995,0.7,1,1,1,0,0,0,2,0,2,0,0,0,1,2,1,0,21/22
David de Gea,es ESP,GK,Manchester Utd,30,1990,38,0,0,0,0,0,0,0,,0,0,0,0,0,0,11,2,21/22
Joe Gelhardt,eng ENG,FWMF,Leeds United,19,2002,8.3,4,3,1,0,3,2,10,20,8,9,0,9,0,4,3,0,21/22
Anwar El Ghazi,nl NED,FWMF,Aston Villa,26,1995,4.3,4,4,2,2,0,2,7,28.6,5,6,0,6,1,5,2,0,21/22
Anwar El Ghazi,nl NED,FWMF,Everton,26,1995,0.1,1,1,1,0,0,1,1,100,0,3,0,3,0,1,0,0,21/22
Saman Ghoddos,ir IRN,MFDF,Brentford,27,1993,6,17,10,8,6,3,9,15,60,6,2,0,2,3,20,16,0,21/22
Dimitris Giannoulis,gr GRE,DF,Norwich City,25,1995,13,36,21,17,17,2,24,36,66.7,12,22,6,16,19,55,41,1,21/22
Morgan Gibbs-White,eng ENG,DFFW,Wolves,21,2000,0.1,0,0,0,0,0,0,0,,0,1,0,1,0,0,0,0,21/22
Ben Gibson,eng ENG,DF,Norwich City,28,1993,27.7,23,16,17,6,0,7,12,58.3,5,36,30,6,27,50,139,2,21/22
Billy Gilmour,sct SCO,MF,Norwich City,20,2001,20.6,41,21,16,21,4,14,52,26.9,38,21,4,17,17,58,29,0,21/22
Ben Godfrey,eng ENG,DF,Everton,23,1998,22.5,47,32,29,14,4,24,39,61.5,15,41,19,22,15,62,100,2,21/22
André Gomes,pt POR,MF,Everton,28,1993,6.9,16,4,6,6,4,8,32,25,24,8,2,6,1,17,7,1,21/22
Toti Gomes,pt POR,DF,Wolves,22,1999,4,11,7,10,1,0,7,9,77.8,2,6,3,3,8,19,15,0,21/22
Joe Gomez,eng ENG,DF,Liverpool,24,1997,3.7,10,6,5,2,3,5,9,55.6,4,4,1,3,5,15,6,0,21/22
Charlie Goode,eng ENG,DF,Brentford,25,1995,5,7,5,5,2,0,4,4,100,0,4,2,2,2,9,8,0,21/22
Anthony Gordon,eng ENG,MFFW,Everton,20,2001,25.4,54,32,20,30,4,21,59,35.6,38,49,3,46,22,76,17,0,21/22
Kaide Gordon,eng ENG,FW,Liverpool,16,2004,0.1,1,0,0,0,1,0,0,,0,0,0,0,0,1,0,0,21/22
Dan Gosling,eng ENG,MF,Watford,31,1990,1.8,2,1,1,1,0,2,6,33.3,4,2,0,2,0,2,3,0,21/22
Demarai Gray,eng ENG,MFFW,Everton,25,1996,26,30,19,13,10,7,10,22,45.5,12,30,2,28,15,45,21,1,21/22
Jack Grealish,eng ENG,FW,Manchester City,25,1995,21.3,18,17,4,10,4,5,13,38.5,8,11,1,10,8,26,7,0,21/22
Mason Greenwood,eng ENG,FWMF,Manchester Utd,19,2001,14.1,15,9,9,1,5,3,9,33.3,6,5,0,5,1,16,6,0,21/22
Sam Greenwood,eng ENG,MFFW,Leeds United,19,2002,2.6,8,5,0,5,3,4,7,57.1,3,3,0,3,2,10,1,0,21/22
Pascal Groß,de GER,MFDF,Brighton,30,1991,22.6,28,15,15,11,2,12,33,36.4,21,34,8,26,18,46,23,0,21/22
Vicente Guaita,es ESP,GK,Crystal Palace,34,1987,29.5,1,0,1,0,0,1,1,100,0,0,0,0,1,2,8,1,21/22
Marc Guéhi,eng ENG,DF,Crystal Palace,21,2000,35.8,35,17,24,10,1,15,16,93.8,1,34,26,8,30,65,127,0,21/22
Bruno Guimarães,br BRA,MF,Newcastle Utd,23,1997,11.5,44,23,18,22,4,21,38,55.3,17,25,6,19,9,53,13,0,21/22
İlkay Gündoğan,de GER,MF,Manchester City,30,1990,20.6,23,9,10,12,1,12,31,38.7,19,11,1,10,15,38,10,0,21/22
Angus Gunn,sct SCO,GK,Norwich City,25,1996,9,0,0,0,0,0,0,0,,0,0,0,0,0,0,11,0,21/22
Grant Hanley,sct SCO,DF,Norwich City,29,1991,32.2,44,25,28,14,2,18,35,51.4,17,56,45,11,56,100,176,2,21/22
Jack Harrison,eng ENG,FWMF,Leeds United,24,1996,29.3,57,37,22,22,13,31,76,40.8,45,35,1,34,21,78,19,0,21/22
Kortney Hause,eng ENG,DF,Aston Villa,26,1995,4.4,3,3,2,0,1,3,4,75,1,8,5,3,6,9,13,0,21/22
Kai Havertz,de GER,FWMF,Chelsea,22,1999,20.1,17,8,5,7,5,4,14,28.6,10,28,1,27,4,21,32,1,21/22
Isaac Hayden,eng ENG,MFDF,Newcastle Utd,26,1995,11.1,28,14,11,14,3,12,29,41.4,17,17,8,9,14,42,24,0,21/22
Hwang Hee-chan,kr KOR,FWMF,Wolves,25,1996,20.2,27,13,9,16,2,14,44,31.8,30,10,0,10,13,40,7,1,21/22
Jordan Henderson,eng ENG,MF,Liverpool,31,1990,28.9,36,20,9,25,2,17,44,38.6,27,25,1,24,23,59,14,0,21/22
Jeff Hendrick,ie IRL,MF,Newcastle Utd,29,1992,0.8,1,1,0,1,0,1,1,100,0,0,0,0,0,1,1,0,21/22
Wayne Hennessey,wls WAL,GK,Burnley,34,1987,2,0,0,0,0,0,0,0,,0,0,0,0,1,1,0,1,21/22
Rico Henry,eng ENG,DF,Brentford,24,1997,30.8,28,20,18,8,2,12,34,35.3,22,31,10,21,26,54,76,1,21/22
Son Heung-min,kr KOR,MFFW,Tottenham,29,1992,33.4,15,6,5,7,3,5,23,21.7,18,27,6,21,13,28,8,0,21/22
Ki-Jana Hoever,nl NED,DFMF,Wolves,19,2002,3.4,10,6,5,5,0,7,12,58.3,5,6,0,6,6,16,8,0,21/22
Rob Holding,eng ENG,DF,Arsenal,25,1995,9.4,13,9,11,1,1,5,6,83.3,1,23,18,5,10,23,42,1,21/22
Mason Holgate,eng ENG,DF,Everton,24,1996,23.7,35,18,26,9,0,11,26,42.3,15,25,17,8,26,61,95,1,21/22
Callum Hudson-Odoi,eng ENG,MFFW,Chelsea,20,2000,10.7,14,10,5,6,3,8,23,34.8,15,8,0,8,2,16,6,1,21/22
Will Hughes,eng ENG,MF,Crystal Palace,26,1995,11.7,29,14,10,16,3,7,16,43.8,9,13,7,6,8,37,10,0,21/22
Pierre Højbjerg,dk DEN,MF,Tottenham,25,1995,35.5,78,45,31,38,9,38,85,44.7,47,61,13,48,48,126,54,0,21/22
Adam Idah,ie IRL,FWMF,Norwich City,20,2001,6.9,9,6,2,5,2,2,3,66.7,1,4,2,2,3,12,7,0,21/22
Kelechi Iheanacho,ng NGA,FW,Leicester City,24,1996,14,10,7,2,5,3,3,14,21.4,11,19,0,19,4,14,10,0,21/22
Danny Ings,eng ENG,FW,Aston Villa,29,1992,21.1,23,16,2,16,5,13,37,35.1,24,31,2,29,6,29,22,0,21/22
Tim Iroegbunam,eng ENG,MF,Aston Villa,18,2003,1,5,4,2,3,0,1,1,100,0,0,0,0,2,7,1,0,21/22
Alex Iwobi,ng NGA,MFDF,Everton,25,1996,22.6,40,19,23,12,5,21,52,40.4,31,39,3,36,20,60,25,2,21/22
Daniel James,wls WAL,FW,Manchester Utd,23,1997,1.4,2,1,0,2,0,0,0,,0,2,0,2,0,2,1,0,21/22
Daniel James,wls WAL,FWMF,Leeds United,23,1997,26.3,24,14,8,8,8,10,23,43.5,13,18,1,17,8,32,12,0,21/22
Reece James,eng ENG,DF,Chelsea,21,1999,20.7,33,25,14,18,1,9,22,40.9,13,20,2,18,17,50,22,0,21/22
Vitaly Janelt,de GER,MF,Brentford,23,1998,25.5,61,32,26,27,8,27,53,50.9,26,23,7,16,28,89,35,0,21/22
Pontus Jansson,se SWE,DF,Brentford,30,1991,36.9,40,21,32,8,0,22,34,64.7,12,37,27,10,52,92,187,0,21/22
Mathias Jensen,dk DEN,MF,Brentford,25,1996,17.8,33,18,12,16,5,22,63,34.9,41,32,3,29,22,55,13,0,21/22
Gabriel Jesus,br BRA,FW,Manchester City,24,1997,20.9,18,12,2,4,12,6,26,23.1,20,18,0,18,15,33,8,0,21/22
Raúl Jiménez,mx MEX,FW,Wolves,30,1991,29.2,29,14,6,16,7,6,30,20,24,31,5,26,13,42,26,0,21/22
João Pedro,br BRA,FWMF,Watford,19,2001,18.3,20,14,7,8,5,6,23,26.1,17,23,3,20,15,35,17,0,21/22
Joelinton,br BRA,MFFW,Newcastle Utd,24,1996,28.4,72,38,30,33,9,26,61,42.6,35,46,11,35,34,106,50,2,21/22
Ben Johnson,eng ENG,DF,West Ham,21,2000,15.5,33,16,15,15,3,21,28,75,7,16,8,8,22,55,55,0,21/22
Curtis Jones,eng ENG,MF,Liverpool,20,2001,9.5,11,9,3,6,2,1,10,10,9,4,0,4,6,17,4,0,21/22
Phil Jones,eng ENG,DF,Manchester Utd,29,1992,1.8,5,5,3,1,1,2,3,66.7,1,4,4,0,3,8,8,0,21/22
Jorginho,it ITA,MF,Chelsea,29,1991,25.3,64,33,27,31,6,29,83,34.9,54,27,4,23,36,100,21,1,21/22
Diogo Jota,pt POR,FW,Liverpool,24,1996,26.3,39,18,12,18,9,13,55,23.6,42,19,2,17,6,45,6,0,21/22
James Justin,eng ENG,DF,Leicester City,23,1998,11.1,22,13,11,8,3,7,15,46.7,8,16,4,12,17,39,34,0,21/22
Mathias Jørgensen,dk DEN,DF,Brentford,31,1990,5.8,10,4,3,5,2,7,10,70,3,6,1,5,10,20,13,0,21/22
Ozan Kabak,tr TUR,DF,Norwich City,21,2000,10.2,10,5,4,6,0,5,9,55.6,4,19,11,8,16,26,26,0,21/22
Christian Kabasele,be BEL,DF,Watford,30,1991,13.3,11,5,10,1,0,7,10,70,3,20,16,4,14,25,67,1,21/22
Samuel Kalu,ng NGA,FW,Watford,23,1997,2.5,2,2,0,2,0,1,1,100,0,2,0,2,3,5,3,0,21/22
Hassane Kamara,ci CIV,DF,Watford,27,1994,18,53,34,31,16,6,27,43,62.8,16,20,4,16,69,122,67,0,21/22
Harry Kane,eng ENG,FW,Tottenham,28,1993,35.9,15,5,2,10,3,7,18,38.9,11,26,8,18,3,18,39,0,21/22
N'Golo Kanté,fr FRA,MF,Chelsea,30,1991,19.7,59,31,20,27,12,25,40,62.5,15,37,2,35,31,90,8,0,21/22
Edo Kayembe,cd COD,MF,Watford,23,1998,8.9,21,13,11,9,1,8,16,50,8,6,1,5,9,30,13,0,21/22
Moise Kean,it ITA,FW,Everton,21,2000,0,0,0,0,0,0,0,0,,0,0,0,0,0,0,0,0,21/22
Michael Keane,eng ENG,DF,Everton,28,1993,31,46,25,32,13,1,28,45,62.2,17,33,28,5,62,108,128,2,21/22
Naby Keïta,gn GUI,MF,Liverpool,26,1995,13,46,23,17,19,10,26,42,61.9,16,33,2,31,14,60,8,0,21/22
Caoimhín Kelleher,ie IRL,GK,Liverpool,22,1998,2,1,1,1,0,0,1,1,100,0,0,0,0,0,1,1,0,21/22
Kenedy,br BRA,DF,Chelsea,25,1996,0.6,5,2,1,2,2,2,3,66.7,1,0,0,0,0,5,0,0,21/22
Jonjoe Kenny,eng ENG,DF,Everton,24,1997,11.3,17,7,11,6,0,13,21,61.9,8,8,1,7,20,37,31,0,21/22
Max Kilman,eng ENG,DF,Wolves,24,1997,29.9,50,26,38,10,2,24,37,64.9,13,36,21,15,45,95,113,3,21/22
Joshua King,no NOR,FW,Watford,29,1992,25,19,15,7,6,6,4,17,23.5,13,15,4,11,8,27,31,0,21/22
Kristoffer Klaesson,no NOR,GK,Leeds United,20,2000,0.4,0,0,0,0,0,0,0,,0,0,0,0,0,0,0,0,21/22
Mateusz Klich,pl POL,MF,Leeds United,31,1990,23,47,25,18,23,6,25,66,37.9,41,22,4,18,11,58,20,0,21/22
Robin Koch,de GER,MFDF,Leeds United,25,1996,17.5,21,13,9,10,2,9,34,26.5,25,26,10,16,20,41,44,0,21/22
Sead Kolašinac,ba BIH,DF,Arsenal,28,1993,1,0,0,0,0,0,0,0,,0,0,0,0,4,4,1,0,21/22
Ibrahima Konaté,fr FRA,DF,Liverpool,22,1999,11,16,10,9,6,1,7,10,70,3,13,9,4,16,32,37,1,21/22
Ezri Konsa,eng ENG,DF,Aston Villa,23,1997,27.5,25,15,13,11,1,10,13,76.9,3,31,22,9,15,40,86,2,21/22
Cheikhou Kouyaté,sn SEN,MF,Crystal Palace,31,1989,21.9,52,38,28,22,2,18,39,46.2,21,40,14,26,38,90,39,0,21/22
Mateo Kovačić,hr CRO,MF,Chelsea,27,1994,17.3,51,31,14,26,11,17,35,48.6,18,19,4,15,7,58,9,1,21/22
Emil Krafth,se SWE,DF,Newcastle Utd,26,1994,18.2,37,16,25,11,1,27,36,75,9,16,10,6,25,62,56,0,21/22
Alex Král,cz CZE,MF,West Ham,23,1998,0,0,0,0,0,0,0,0,,0,0,0,0,0,0,0,0,21/22
Tim Krul,nl NED,GK,Norwich City,33,1988,29,1,1,1,0,0,1,4,25,3,0,0,0,0,1,10,4,21/22
Juraj Kucka,sk SVK,MF,Watford,34,1987,21.3,59,39,32,25,2,27,73,37,46,30,9,21,27,86,46,2,21/22
Dejan Kulusevski,se SWE,MFFW,Tottenham,21,2000,14,19,13,7,10,2,5,23,21.7,18,14,0,14,13,32,3,0,21/22
Alexandre Lacazette,fr FRA,FW,Arsenal,30,1991,19.8,27,10,8,13,6,7,21,33.3,14,12,1,11,5,32,6,0,21/22
Adam Lallana,eng ENG,MF,Brighton,33,1988,17.3,34,17,14,14,6,12,41,29.3,29,16,6,10,16,50,13,1,21/22
Tariq Lamptey,gh GHA,DFFW,Brighton,20,2000,17.3,36,25,14,17,5,15,25,60,10,13,3,10,21,57,23,0,21/22
Manuel Lanzini,ar ARG,MFFW,West Ham,28,1993,19.8,28,15,10,11,7,10,35,28.6,25,16,0,16,19,47,10,0,21/22
Aymeric Laporte,es ESP,DF,Manchester City,27,1994,31.4,33,15,22,10,1,14,20,70,6,15,10,5,20,53,64,2,21/22
Jamaal Lascelles,eng ENG,DF,Newcastle Utd,27,1993,22.9,15,7,9,5,1,4,12,33.3,8,38,28,10,22,37,121,1,21/22
Pierre Lees-Melou,fr FRA,MF,Norwich City,28,1993,25.2,58,36,23,29,6,25,92,27.2,67,37,11,26,25,83,23,0,21/22
Aaron Lennon,eng ENG,MFFW,Burnley,34,1987,17.2,33,17,10,13,10,10,34,29.4,24,26,4,22,9,42,14,0,21/22
Bernd Leno,de GER,GK,Arsenal,29,1992,4,1,1,1,0,0,1,1,100,0,0,0,0,0,1,1,0,21/22
Jamal Lewis,nir NIR,DF,Newcastle Utd,23,1998,2.9,8,6,6,1,1,3,4,75,1,3,2,1,3,11,8,0,21/22
Victor Lindelöf,se SWE,DF,Manchester Utd,27,1994,26.2,16,11,9,7,0,9,14,64.3,5,26,17,9,25,41,96,0,21/22
Jesse Lingard,eng ENG,FWMF,Manchester Utd,28,1992,4.1,9,7,4,3,2,2,6,33.3,4,4,0,4,0,9,1,0,21/22
Valentino Livramento,eng ENG,DF,Southampton,18,2002,24.5,54,28,30,18,6,27,45,60,18,23,9,14,47,101,50,1,21/22
Diego Llorente,es ESP,DF,Leeds United,27,1993,26,53,31,32,19,2,33,47,70.2,14,35,17,18,40,93,77,2,21/22
Hugo Lloris,fr FRA,GK,Tottenham,34,1986,38,1,1,1,0,0,1,2,50,1,0,0,0,1,2,24,3,21/22
Giovani Lo Celso,ar ARG,MFFW,Tottenham,25,1996,2.6,8,4,4,2,2,4,10,40,6,6,1,5,1,9,0,1,21/22
Jürgen Locadia,nl NED,MFFW,Brighton,27,1993,0.3,0,0,0,0,0,0,0,,0,0,0,0,0,0,0,0,21/22
Ruben Loftus-Cheek,eng ENG,MFDF,Chelsea,25,1996,15.5,29,10,16,11,2,10,19,52.6,9,15,6,9,11,40,17,0,21/22
Kevin Long,ie IRL,DF,Burnley,30,1990,4.6,3,2,1,2,0,1,2,50,1,4,1,3,1,4,20,0,21/22
Shane Long,ie IRL,FW,Southampton,34,1987,3.4,9,5,2,4,3,1,1,100,0,4,0,4,0,9,2,0,21/22
Sean Longstaff,eng ENG,MF,Newcastle Utd,23,1997,16.3,54,34,18,31,5,24,65,36.9,41,18,6,12,9,63,18,0,21/22
Ademola Lookman,ng NGA,FWMF,Leicester City,23,1997,16.1,32,14,10,13,9,10,28,35.7,18,19,1,18,10,42,4,0,21/22
Jonas Lössl,dk DEN,GK,Brentford,32,1989,2,0,0,0,0,0,0,0,,0,0,0,0,0,0,1,0,21/22
Imran Louza,ma MAR,MF,Watford,22,1999,15.7,41,21,18,20,3,16,38,42.1,22,28,6,22,42,83,20,1,21/22
Matthew Lowton,eng ENG,DF,Burnley,32,1989,19.7,38,24,20,10,8,20,37,54.1,17,25,11,14,26,64,68,0,21/22
Douglas Luiz,br BRA,MF,Aston Villa,23,1998,30.2,59,39,30,24,5,21,72,29.2,51,30,7,23,34,93,28,1,21/22
Romelu Lukaku,be BEL,FW,Chelsea,28,1993,17.7,2,1,0,1,1,1,5,20,4,11,1,10,0,2,20,0,21/22
Lyanco,br BRA,DF,Southampton,24,1997,10.1,18,15,11,7,0,10,18,55.6,8,18,13,5,13,31,50,1,21/22
Alexis Mac Allister,ar ARG,MFFW,Brighton,22,1998,23.6,65,40,23,30,12,29,68,42.6,39,37,7,30,13,78,22,0,21/22
James Maddison,eng ENG,MFFW,Leicester City,24,1996,27.3,40,20,8,24,8,14,46,30.4,32,18,3,15,11,51,12,0,21/22
Harry Maguire,eng ENG,DF,Manchester Utd,28,1993,27.9,34,21,22,8,4,19,31,61.3,12,36,29,7,32,66,101,3,21/22
Riyad Mahrez,dz ALG,FW,Manchester City,30,1991,16.6,11,3,5,4,2,5,19,26.3,14,15,1,14,6,17,6,0,21/22
Ainsley Maitland-Niles,eng ENG,MF,Arsenal,23,1997,3,8,4,5,3,0,2,4,50,2,2,0,2,4,12,4,0,21/22
Sadio Mané,sn SEN,FW,Liverpool,29,1992,31.3,33,20,7,14,12,8,26,30.8,18,30,1,29,8,41,15,0,21/22
Javier Manquillo,es ESP,DF,Newcastle Utd,27,1994,14,39,29,28,10,1,21,36,58.3,15,15,6,9,10,49,32,0,21/22
Fernando Marçal,br BRA,MFDF,Wolves,32,1989,16.1,42,22,27,14,1,21,37,56.8,16,25,4,21,28,70,52,0,21/22
Solly March,eng ENG,DFFW,Brighton,27,1994,19.4,30,17,11,9,10,7,22,31.8,15,22,3,19,17,47,25,0,21/22
Pablo Marí,es ESP,DF,Arsenal,27,1993,2,5,3,1,3,1,3,6,50,3,5,4,1,3,8,10,0,21/22
Anthony Martial,fr FRA,FW,Manchester Utd,25,1995,2.4,0,0,0,0,0,0,1,0,1,1,0,1,0,0,1,0,21/22
Martinelli,br BRA,FWMF,Arsenal,20,2001,20.7,27,19,7,14,6,10,29,34.5,19,26,1,25,20,47,15,0,21/22
Emiliano Martínez,ar ARG,GK,Aston Villa,28,1992,36,1,1,1,0,0,1,3,33.3,2,0,0,0,0,1,6,1,21/22
Adam Masina,ma MAR,DF,Watford,27,1994,12,24,13,11,10,3,12,29,41.4,17,18,6,12,18,42,45,0,21/22
Arthur Masuaku,cd COD,DFFW,West Ham,27,1993,7.2,31,23,19,11,1,14,23,60.9,9,9,1,8,9,40,17,0,21/22
Juan Mata,es ESP,MF,Manchester Utd,33,1988,2.6,6,4,2,3,1,3,5,60,2,1,0,1,1,7,1,0,21/22
Jean-Philippe Mateta,fr FRA,FW,Crystal Palace,24,1997,12.7,8,4,2,5,1,3,18,16.7,15,11,3,8,4,12,13,0,21/22
Nemanja Matić,rs SRB,MF,Manchester Utd,32,1988,15.4,31,18,19,11,1,15,31,48.4,16,21,6,15,31,62,21,3,21/22
Joël Matip,cm CMR,DF,Liverpool,29,1991,31,47,34,23,19,5,20,31,64.5,11,26,14,12,44,91,93,1,21/22
Neal Maupay,fr FRA,FW,Brighton,24,1996,25.3,17,10,2,6,9,4,18,22.2,14,21,2,19,2,19,2,0,21/22
Bryan Mbeumo,cm CMR,FW,Brentford,21,1999,32.3,28,16,1,12,15,6,20,30,14,21,6,15,11,39,20,0,21/22
James McArthur,sct SCO,MF,Crystal Palace,33,1987,16,33,23,13,19,1,16,44,36.4,28,23,9,14,30,63,27,0,21/22
James Mcatee,eng ENG,MFFW,Manchester City,18,2002,0.2,0,0,0,0,0,0,2,0,2,0,0,0,0,0,0,0,21/22
Kasey McAteer,eng ENG,FW,Leicester City,19,2001,0,0,0,0,0,0,0,0,,0,0,0,0,0,0,0,0,21/22
Liam McCarron,sct SCO,FW,Leeds United,20,2001,0.1,0,0,0,0,0,0,0,,0,1,0,1,0,0,0,0,21/22
Alex McCarthy,eng ENG,GK,Southampton,31,1989,17,0,0,0,0,0,0,0,,0,0,0,0,0,0,4,0,21/22
John McGinn,sct SCO,MF,Aston Villa,26,1994,34.3,106,64,35,55,16,54,104,51.9,50,53,6,47,35,141,34,0,21/22
Stuart McKinstry,sct SCO,MF,Leeds United,18,2002,0,0,0,0,0,0,0,0,,0,0,0,0,0,0,0,0,21/22
Kenny McLean,sct SCO,MF,Norwich City,29,1992,30.1,42,22,18,20,4,17,59,28.8,42,29,7,22,34,76,54,0,21/22
Dwight McNeil,eng ENG,MF,Burnley,21,1999,34.5,78,49,27,38,13,33,73,45.2,40,64,11,53,35,113,31,1,21/22
Scott McTominay,sct SCO,MF,Manchester Utd,24,1996,26.5,65,33,32,24,9,30,61,49.2,31,45,10,35,31,96,60,1,21/22
Ben Mee,eng ENG,DF,Burnley,31,1989,20.4,26,12,16,7,3,12,19,63.2,7,28,22,6,24,50,94,1,21/22
Hannibal Mejbri,tn TUN,FW,Manchester Utd,18,2003,0.8,2,1,1,1,0,1,1,100,0,0,0,0,0,2,0,0,21/22
Benjamin Mendy,fr FRA,DF,Manchester City,27,1994,0.9,2,2,1,1,0,2,6,33.3,4,0,0,0,0,2,0,0,21/22
Edouard Mendy,sn SEN,GK,Chelsea,29,1992,34,1,0,1,0,0,1,3,33.3,2,0,0,0,0,1,13,4,21/22
Nampalys Mendy,sn SEN,MF,Leicester City,29,1992,11.5,12,6,8,4,0,6,17,35.3,11,7,4,3,11,23,11,1,21/22
Illan Meslier,fr FRA,GK,Leeds United,21,2000,37.6,1,1,1,0,0,1,1,100,0,0,0,0,0,1,27,1,21/22
Luka Milivojević,rs SRB,MF,Crystal Palace,30,1991,8.6,18,9,9,6,3,10,16,62.5,6,6,1,5,11,29,15,0,21/22
James Milner,eng ENG,MFDF,Liverpool,35,1986,9.5,28,16,12,11,5,12,29,41.4,17,19,5,14,17,45,20,0,21/22
Yerry Mina,co COL,DF,Everton,26,1994,9.4,12,10,12,0,0,10,13,76.9,3,13,9,4,11,23,38,1,21/22
Takumi Minamino,jp JPN,FWMF,Liverpool,26,1995,2.1,3,2,1,1,1,2,8,25,6,2,0,2,1,4,2,0,21/22
Tyrone Mings,eng ENG,DF,Aston Villa,28,1993,35.4,23,12,17,3,3,14,22,63.6,8,47,30,17,46,69,153,2,21/22
Tyrick Mitchell,eng ENG,DF,Crystal Palace,21,1999,34.5,104,57,67,26,11,46,67,68.7,21,47,5,42,41,145,101,0,21/22
Jakub Moder,pl POL,MF,Brighton,22,1999,18.9,42,25,18,17,7,23,42,54.8,19,25,2,23,10,52,22,1,21/22
Wesley Moraes,br BRA,FW,Aston Villa,24,1996,0,0,0,0,0,0,0,0,,0,0,0,0,0,0,0,0,21/22
Tyler Morton,eng ENG,MF,Liverpool,18,2002,0.7,0,0,0,0,0,0,2,0,2,0,0,0,3,3,0,0,21/22
Mason Mount,eng ENG,MF,Chelsea,22,1999,26.3,41,16,10,17,14,10,34,29.4,24,18,1,17,13,54,12,0,21/22
Lucas Moura,br BRA,FWMF,Tottenham,28,1992,19.7,25,10,7,14,4,8,35,22.9,27,19,0,19,18,43,19,0,21/22
João Moutinho,pt POR,MF,Wolves,34,1986,33,74,39,34,27,13,30,106,28.3,76,48,8,40,34,108,36,2,21/22
Bali Mumba,eng ENG,DF,Norwich City,19,2001,0.5,1,1,1,0,0,0,0,,0,0,0,0,0,1,5,0,21/22
Jacob Murphy,eng ENG,FWDF,Newcastle Utd,26,1995,16.4,49,26,34,11,4,26,41,63.4,15,20,2,18,23,72,17,0,21/22
Enock Mwepu,zm ZAM,MF,Brighton,23,1998,11.1,22,12,10,10,2,5,27,18.5,22,20,2,18,12,34,19,0,21/22
Vitaliy Mykolenko,ua UKR,DF,Everton,22,1999,11.7,25,15,15,7,3,12,21,57.1,9,15,2,13,16,41,37,0,21/22
Marvelous Nakamba,zw ZIM,MF,Aston Villa,27,1994,10,32,19,18,14,0,12,34,35.3,22,14,4,10,12,44,17,1,21/22
Wilfred Ndidi,ng NGA,MFDF,Leicester City,24,1996,18,60,32,32,27,1,22,55,40,33,36,8,28,42,102,54,1,21/22
Tanguy Ndombele,fr FRA,MF,Tottenham,24,1996,5.4,10,7,3,5,2,1,8,12.5,7,5,0,5,1,11,1,0,21/22
Reiss Nelson,eng ENG,FW,Arsenal,21,1999,0.2,1,0,0,0,1,0,1,0,1,1,0,1,0,1,0,0,21/22
Pedro Neto,pt POR,FWMF,Wolves,21,2000,5.2,4,4,2,0,2,0,9,0,9,0,0,0,6,10,1,0,21/22
Rúben Neves,pt POR,MF,Wolves,24,1997,29.6,68,37,23,41,4,24,87,27.6,63,39,5,34,41,109,49,3,21/22
Jeremy Ngakia,eng ENG,DF,Watford,20,2000,10,31,18,23,5,3,11,26,42.3,15,11,4,7,12,43,32,0,21/22
Saúl Ñíguez,es ESP,DFMF,Chelsea,26,1994,5.3,20,9,11,9,0,9,16,56.3,7,14,3,11,7,27,10,1,21/22
Eddie Nketiah,eng ENG,FW,Arsenal,22,1999,9.3,9,4,1,4,4,1,4,25,3,9,2,7,4,13,5,0,21/22
Nicolas Nkoulou,cm CMR,DF,Watford,31,1990,1.9,1,0,0,1,0,0,0,,0,2,1,1,2,3,8,0,21/22
Mark Noble,eng ENG,MF,West Ham,34,1987,3.7,8,2,7,1,0,5,11,45.5,6,4,1,3,4,12,2,1,21/22
Mathias Normann,no NOR,MF,Norwich City,25,1996,18.3,34,21,19,14,1,17,46,37,29,17,8,9,19,53,43,1,21/22
Christian Nørgaard,dk DEN,MF,Brentford,27,1994,33.9,109,60,42,58,9,52,101,51.5,49,48,9,39,64,173,58,1,21/22
Angelo Ogbonna,it ITA,DF,West Ham,33,1988,10.2,7,4,5,2,0,3,7,42.9,4,5,4,1,11,18,29,0,21/22
Michael Olise,fr FRA,FWMF,Crystal Palace,19,2001,12.7,22,18,8,11,3,7,24,29.2,17,17,0,17,6,28,6,0,21/22
Robin Olsen,se SWE,GK,Aston Villa,31,1990,1,0,0,0,0,0,0,0,,0,0,0,0,0,0,0,0,21/22
Andrew Omobamidele,ie IRL,DF,Norwich City,19,2002,4.2,8,6,5,3,0,5,11,45.5,6,8,8,0,5,13,13,0,21/22
Tyler Onyango,eng ENG,MF,Everton,18,2003,0.3,0,0,0,0,0,0,0,,0,0,0,0,0,0,1,0,21/22
Frank Onyeka,ng NGA,MF,Brentford,23,1998,11.6,25,17,13,9,3,8,27,29.6,19,16,2,14,14,39,13,0,21/22
Divock Origi,be BEL,FW,Liverpool,26,1995,1.5,0,0,0,0,0,0,2,0,2,1,0,1,1,1,2,0,21/22
Alex Oxlade-Chamberlain,eng ENG,MFFW,Liverpool,27,1993,8.7,15,11,2,8,5,3,14,21.4,11,12,2,10,6,21,5,0,21/22
Cole Palmer,eng ENG,FWMF,Manchester City,19,2002,1.4,2,1,1,1,0,0,2,0,2,3,0,3,1,3,0,0,21/22
Emerson Palmieri,it ITA,DF,Chelsea,26,1994,0.1,0,0,0,0,0,0,0,,0,0,0,0,0,0,0,0,21/22
Thomas Partey,gh GHA,MF,Arsenal,28,1993,22.5,43,29,22,17,4,18,44,40.9,26,22,4,18,23,66,35,2,21/22
Nicolas Pépé,ci CIV,FWMF,Arsenal,26,1995,7.7,8,5,3,5,0,3,9,33.3,6,9,1,8,8,16,2,0,21/22
Ricardo Pereira,pt POR,DF,Leicester City,27,1993,11,37,20,19,13,5,21,40,52.5,19,13,1,12,17,54,39,0,21/22
Ayoze Pérez,es ESP,MFFW,Leicester City,28,1993,4.9,4,2,0,3,1,0,13,0,13,11,1,10,2,6,5,0,21/22
Sonny Perkins,eng ENG,FW,West Ham,17,2004,0,,0,,,,,,,,,,,0,,,,21/22
Romain Perraud,fr FRA,DF,Southampton,23,1997,18,34,22,18,14,2,16,29,55.2,13,24,6,18,17,51,42,0,21/22
Kalvin Phillips,eng ENG,MF,Leeds United,25,1995,17.7,54,25,24,25,5,24,57,42.1,33,37,9,28,24,78,18,0,21/22
Jaden Philogene Bidace,eng ENG,FW,Aston Villa,19,2002,0.1,0,0,0,0,0,0,0,,0,0,0,0,0,0,0,0,21/22
Jordan Pickford,eng ENG,GK,Everton,27,1994,35,1,1,1,0,0,0,1,0,1,1,0,1,1,2,14,1,21/22
Erik Pieters,nl NED,DF,Burnley,32,1988,8.1,28,15,15,11,2,17,28,60.7,11,18,7,11,10,38,38,0,21/22
Ethan Pinnock,jm JAM,DF,Brentford,28,1993,29.9,51,35,37,12,2,25,38,65.8,13,30,11,19,44,95,154,1,21/22
Daniel Podence,pt POR,FWMF,Wolves,25,1995,16.5,18,11,10,5,3,4,17,23.5,13,8,1,7,10,28,1,0,21/22
Paul Pogba,fr FRA,MFFW,Manchester Utd,28,1993,15,13,9,5,7,1,6,28,21.4,22,11,0,11,13,26,16,0,21/22
Nick Pope,eng ENG,GK,Burnley,29,1992,36,0,0,0,0,0,0,2,0,2,0,0,0,2,2,30,3,21/22
Isaac Price,nir NIR,MF,Everton,17,2003,0.2,0,0,0,0,0,0,0,,0,1,0,1,0,0,0,0,21/22
Teemu Pukki,fi FIN,FW,Norwich City,31,1990,36.1,23,11,2,14,7,6,29,20.7,23,21,1,20,4,27,3,0,21/22
Christian Pulisic,us USA,MFFW,Chelsea,22,1998,14.3,10,7,6,3,1,3,17,17.6,14,12,0,12,5,15,10,0,21/22
Przemysław Płacheta,pl POL,FWMF,Norwich City,23,1998,5.6,4,3,3,1,0,2,7,28.6,5,3,1,2,2,6,5,1,21/22
Jesuran Rak Sakyi,eng ENG,FWMF,Crystal Palace,18,2002,0.9,0,0,0,0,0,0,1,0,1,3,0,3,1,1,0,0,21/22
Aaron Ramsdale,eng ENG,GK,Arsenal,23,1998,34,2,1,2,0,0,1,2,50,1,0,0,0,0,2,26,3,21/22
Jacob Ramsey,eng ENG,MF,Aston Villa,20,2001,27.4,67,44,31,28,8,30,69,43.5,39,36,7,29,24,91,28,0,21/22
Raphinha,br BRA,FWMF,Leeds United,24,1996,32.4,51,29,25,14,12,22,71,31,49,43,0,43,29,80,28,1,21/22
Marcus Rashford,eng ENG,FWMF,Manchester Utd,23,1997,13.7,6,5,1,4,1,2,13,15.4,11,10,1,9,5,11,5,1,21/22
Milot Rashica,xk KVX,FWMF,Norwich City,25,1996,24.8,31,19,12,12,7,11,30,36.7,19,22,3,19,15,46,23,0,21/22
David Raya,es ESP,GK,Brentford,25,1995,24,0,0,0,0,0,0,0,,0,1,0,1,0,0,10,1,21/22
Nathan Redmond,eng ENG,MFFW,Southampton,27,1994,20.4,22,14,9,9,4,7,30,23.3,23,21,2,19,8,30,16,0,21/22
Sergio Reguilón,es ESP,DFMF,Tottenham,24,1996,21.3,40,24,15,18,7,22,43,51.2,21,20,8,12,31,71,45,1,21/22
Declan Rice,eng ENG,MF,West Ham,22,1999,35.3,80,42,45,32,3,38,71,53.5,33,45,21,24,63,143,52,1,21/22
Taylor Richards,eng ENG,MF,Brighton,20,2000,0.3,1,0,0,1,0,1,2,50,1,0,0,0,0,1,0,0,21/22
Richarlison,br BRA,FW,Everton,24,1997,28,40,23,18,15,7,15,31,48.4,16,42,4,38,12,52,34,0,21/22
Jaïro Riedewald,nl NED,MF,Crystal Palace,24,1996,1.3,1,1,0,1,0,1,2,50,1,1,0,1,1,2,2,0,21/22
Matt Ritchie,sct SCO,DF,Newcastle Utd,31,1989,14.9,22,15,10,10,2,10,27,37,17,10,2,8,13,35,26,0,21/22
Connor Roberts,wls WAL,DF,Burnley,25,1995,18.8,20,13,10,7,3,10,15,66.7,5,25,5,20,22,42,62,1,21/22
Tyler Roberts,wls WAL,MFFW,Leeds United,22,1999,11,16,7,6,7,3,9,16,56.3,7,11,1,10,5,21,11,0,21/22
Andrew Robertson,sct SCO,DF,Liverpool,27,1994,28.2,36,21,16,15,5,20,35,57.1,15,24,3,21,23,59,61,0,21/22
Joe Rodon,wls WAL,DF,Tottenham,23,1997,1,0,0,0,0,0,0,0,,0,2,1,1,0,0,7,0,21/22
Rodri,es ESP,MF,Manchester City,25,1996,32,72,43,24,38,10,32,59,54.2,27,28,5,23,28,100,45,0,21/22
Rodrigo,es ESP,MFFW,Leeds United,30,1991,25.2,20,9,7,6,7,4,32,12.5,28,12,0,12,11,31,27,1,21/22
Jay Rodriguez,eng ENG,FW,Burnley,32,1989,15.4,20,12,8,8,4,4,14,28.6,10,19,1,18,4,24,12,0,21/22
Mads Roerslev,dk DEN,DF,Brentford,22,1999,13.8,23,12,19,2,2,14,32,43.8,18,14,5,9,16,39,29,0,21/22
Cristian Romero,ar ARG,DF,Tottenham,23,1998,20.5,62,39,39,21,2,22,34,64.7,12,46,21,25,33,95,74,1,21/22
Oriol Romeu,es ESP,MF,Southampton,29,1991,32.1,77,39,25,45,7,28,73,38.4,45,39,8,31,51,128,43,0,21/22
Cristiano Ronaldo,pt POR,FW,Manchester Utd,36,1985,27.3,8,6,1,5,2,2,6,33.3,4,8,0,8,2,10,29,0,21/22
Salomón Rondón,ve VEN,FW,Everton,31,1989,8.8,6,1,1,2,3,4,14,28.6,10,5,0,5,0,6,10,0,21/22
Danny Rose,eng ENG,DF,Watford,31,1990,7.7,16,10,11,4,1,10,24,41.7,14,8,5,3,14,30,11,1,21/22
Jon Rowe,eng ENG,FWMF,Norwich City,18,2003,2.5,3,2,2,1,0,2,3,66.7,1,7,0,7,3,6,1,0,21/22
John Ruddy,eng ENG,GK,Wolves,34,1986,1.5,0,0,0,0,0,0,0,,0,0,0,0,0,0,3,0,21/22
Antonio Rüdiger,de GER,DF,Chelsea,28,1993,33.7,48,28,29,15,4,36,48,75,12,20,11,9,28,76,91,1,21/22
Lukas Rupp,de GER,MF,Norwich City,30,1991,8.5,9,4,5,3,1,4,15,26.7,11,11,1,10,9,18,7,0,21/22
José Sá,pt POR,GK,Wolves,28,1993,36.5,2,1,2,0,0,2,4,50,2,0,0,0,2,4,19,5,21/22
Allan Saint-Maximin,fr FRA,FWMF,Newcastle Utd,24,1997,31.2,13,8,6,4,3,3,17,17.6,14,13,2,11,11,24,3,0,21/22
Romain Saïss,ma MAR,DF,Wolves,31,1990,30.1,40,27,28,11,1,19,33,57.6,14,41,21,20,58,98,158,2,21/22
Bukayo Saka,eng ENG,FWMF,Arsenal,19,2001,33.1,40,21,12,17,11,13,39,33.3,26,28,2,26,22,62,23,0,21/22
Mohamed Salah,eg EGY,FW,Liverpool,29,1992,30.7,17,8,5,9,3,6,19,31.6,13,7,1,6,6,23,5,0,21/22
Mohammed Salisu,gh GHA,DF,Southampton,22,1999,33,80,47,54,22,4,40,65,61.5,25,49,26,23,78,158,158,4,21/22
Albert Sambi Lokonga,be BEL,MF,Arsenal,21,1999,12.6,22,18,11,9,2,12,14,85.7,2,12,7,5,13,35,12,4,21/22
Davinson Sánchez,co COL,DF,Tottenham,25,1996,18.1,41,22,25,14,2,19,28,67.9,9,24,16,8,30,71,54,3,21/22
Robert Sánchez,es ESP,GK,Brighton,23,1997,37,2,1,2,0,0,1,1,100,0,1,0,1,0,2,11,4,21/22
Jadon Sancho,eng ENG,FWMF,Manchester Utd,21,2000,21.1,14,8,9,4,1,8,22,36.4,14,19,0,19,15,29,5,3,21/22
Morgan Sanson,fr FRA,MF,Aston Villa,26,1994,4,12,8,7,2,3,3,7,42.9,4,13,0,13,10,22,2,1,21/22
Samir Santos,br BRA,DF,Watford,26,1994,18.6,24,11,18,6,0,8,19,42.1,11,21,11,10,43,67,85,3,21/22
Josh Sargent,us USA,FWMF,Norwich City,21,2000,17.5,26,14,15,7,4,14,39,35.9,25,29,2,27,11,37,18,2,21/22
Jeremy Sarmiento,ec ECU,FWMF,Brighton,19,2002,0.5,1,1,0,0,1,0,2,0,2,2,0,2,0,1,0,0,21/22
Ismaila Sarr,sn SEN,FWMF,Watford,23,1998,20.7,12,7,4,3,5,5,19,26.3,14,10,1,9,9,21,10,0,21/22
Malang Sarr,fr FRA,DF,Chelsea,22,1999,6.1,14,7,10,2,2,7,12,58.3,5,6,3,3,11,25,20,0,21/22
Dane Scarlett,eng ENG,MF,Tottenham,17,2004,0,0,0,0,0,0,0,0,,0,0,0,0,0,0,0,0,21/22
Fabian Schär,ch SUI,DF,Newcastle Utd,29,1991,24,16,11,11,3,2,8,16,50,8,27,18,9,32,48,95,2,21/22
Jeffrey Schlupp,gh GHA,MFFW,Crystal Palace,28,1992,20.6,46,25,16,23,7,24,50,48,26,39,9,30,18,64,32,0,21/22
Kasper Schmeichel,dk DEN,GK,Leicester City,34,1986,37,0,0,0,0,0,0,2,0,2,0,0,0,1,1,15,2,21/22
Ken Sema,se SWE,MFFW,Watford,27,1993,9.5,16,6,11,4,1,9,20,45,11,10,0,10,5,21,11,0,21/22
Nélson Semedo,pt POR,MFDF,Wolves,27,1993,23.7,58,39,39,17,2,25,49,51,24,23,4,19,21,79,64,1,21/22
Ryan Sessegnon,eng ENG,DFMF,Tottenham,21,2000,11.6,25,19,14,7,4,11,22,50,11,18,3,15,7,32,26,0,21/22
Jamie Shackleton,eng ENG,DFMF,Leeds United,21,1999,7.9,27,16,19,7,1,13,25,52,12,11,7,4,8,35,12,1,21/22
Luke Shaw,eng ENG,DF,Manchester Utd,26,1995,17.8,21,13,9,9,3,12,21,57.1,9,22,11,11,9,30,22,2,21/22
Jonjo Shelvey,eng ENG,MF,Newcastle Utd,29,1992,22,30,17,12,18,0,14,34,41.2,20,22,7,15,22,52,20,2,21/22
Shola Shoretire,eng ENG,MF,Manchester Utd,17,2004,0.2,0,0,0,0,0,0,0,,0,0,0,0,0,0,0,0,21/22
Francisco Sierralta,cl CHI,DF,Watford,24,1997,4.7,7,3,7,0,0,5,8,62.5,3,7,2,5,6,13,35,0,21/22
Bernardo Silva,pt POR,MFFW,Manchester City,26,1994,31.7,57,29,19,19,19,31,67,46.3,36,24,2,22,20,77,19,0,21/22
Fábio Silva,pt POR,FW,Wolves,19,2002,6.4,3,2,0,2,1,0,8,0,8,2,0,2,1,4,1,0,21/22
Thiago Silva,br BRA,DF,Chelsea,36,1984,29.4,32,21,19,12,1,11,22,50,11,54,31,23,44,76,100,0,21/22
Ellis Simms,eng ENG,FW,Everton,20,2001,0.7,0,0,0,0,0,0,0,,0,1,1,0,0,0,1,0,21/22
Moussa Sissoko,fr FRA,MF,Watford,31,1989,35.8,53,27,27,20,6,28,42,66.7,14,42,13,29,30,83,64,0,21/22
Oliver Skipp,eng ENG,MF,Tottenham,20,2000,15,33,19,14,18,1,15,31,48.4,16,19,7,12,12,45,10,1,21/22
William Smallbone,ie IRL,MFFW,Southampton,21,2000,1.5,4,4,2,2,0,1,3,33.3,2,4,0,4,2,6,0,0,21/22
Emile Smith Rowe,eng ENG,MFFW,Arsenal,21,2000,21.3,14,7,7,7,0,4,20,20,16,18,1,17,15,29,10,1,21/22
Cédric Soares,pt POR,DF,Arsenal,29,1991,16.5,38,26,23,9,6,16,25,64,9,18,7,11,16,54,31,1,21/22
Tomáš Souček,cz CZE,MF,West Ham,26,1995,34,66,32,27,33,6,28,65,43.1,37,34,13,21,52,118,98,1,21/22
Boubakary Soumaré,fr FRA,MF,Leicester City,22,1999,12.2,19,13,10,8,1,8,17,47.1,9,13,1,12,14,33,18,0,21/22
Çağlar Söyüncü,tr TUR,DF,Leicester City,25,1996,27.7,47,30,32,12,3,26,42,61.9,16,44,27,17,32,79,115,1,21/22
Tony Springett,eng ENG,MFFW,Norwich City,18,2002,1.6,2,1,1,1,0,1,4,25,3,0,0,0,0,2,2,0,21/22
Jason Steele,eng ENG,GK,Brighton,30,1990,1,0,0,0,0,0,0,0,,0,0,0,0,0,0,0,0,21/22
Jed Steer,eng ENG,GK,Aston Villa,28,1992,1,0,0,0,0,0,0,0,,0,0,0,0,0,0,0,0,21/22
Zack Steffen,us USA,GK,Manchester City,26,1995,1,0,0,0,0,0,0,0,,0,0,0,0,0,0,2,0,21/22
Dale Stephens,eng ENG,MF,Burnley,32,1989,1.4,4,1,0,3,1,3,8,37.5,5,4,1,3,1,5,1,0,21/22
Jack Stephens,eng ENG,DF,Southampton,27,1994,9,19,12,13,5,1,6,16,37.5,10,12,7,5,19,38,42,0,21/22
Raheem Sterling,eng ENG,FW,Manchester City,26,1994,23.6,23,10,3,11,9,10,23,43.5,13,12,0,12,12,35,3,0,21/22
Finley Stevens,wls WAL,DF,Brentford,18,2003,0.2,3,1,0,3,0,1,1,100,0,0,0,0,0,3,0,0,21/22
John Stones,eng ENG,DF,Manchester City,27,1994,12.4,5,3,3,2,0,2,3,66.7,1,3,3,0,11,16,27,1,21/22
Pascal Struijk,nl NED,DFMF,Leeds United,21,1999,22.8,61,39,34,23,4,30,50,60,20,35,23,12,33,94,60,2,21/22
Crysencio Summerville,nl NED,MFFW,Leeds United,19,2001,1.4,5,3,1,1,3,2,3,66.7,1,2,0,2,2,7,0,0,21/22
Jakob Sørensen,dk DEN,MFDF,Norwich City,23,1998,6.7,22,11,6,14,2,10,20,50,10,7,3,4,10,32,19,0,21/22
Japhet Tanganga,eng ENG,DF,Tottenham,22,1999,8.2,14,8,7,6,1,9,19,47.4,10,13,5,8,9,23,31,0,21/22
Matt Targett,eng ENG,DF,Aston Villa,25,1995,15.9,34,18,28,5,1,24,45,53.3,21,16,9,7,23,57,35,0,21/22
Matt Targett,eng ENG,DF,Newcastle Utd,25,1995,16,41,26,26,14,1,24,37,64.9,13,15,4,11,25,66,39,1,21/22
James Tarkowski,eng ENG,DF,Burnley,28,1992,34.5,65,45,47,17,1,33,47,70.2,14,75,61,14,48,113,186,4,21/22
Nuno Tavares,pt POR,DF,Arsenal,21,2000,13.1,21,14,10,7,4,8,18,44.4,10,15,5,10,9,30,33,1,21/22
Charlie Taylor,eng ENG,DF,Burnley,27,1993,30.3,45,26,31,11,3,26,44,59.1,18,42,20,22,58,103,95,2,21/22
Nathan Tella,eng ENG,MFFW,Southampton,22,1999,8.9,13,9,5,7,1,6,17,35.3,11,13,0,13,6,19,9,0,21/22
Alex Telles,br BRA,DF,Manchester Utd,28,1992,18.4,48,27,35,9,4,27,43,62.8,16,17,4,13,26,74,45,0,21/22
Luke Thomas,eng ENG,DF,Leicester City,20,2001,21.2,50,31,33,13,4,28,65,43.1,37,35,14,21,40,90,55,0,21/22
Dominic Thompson,eng ENG,DF,Brentford,21,2000,1.6,1,0,1,0,0,0,1,0,1,2,2,0,2,3,3,0,21/22
Youri Tielemans,be BEL,MF,Leicester City,24,1997,29.2,74,38,23,45,6,42,100,42,58,47,13,34,21,95,41,3,21/22
Kieran Tierney,sct SCO,DF,Arsenal,24,1997,21.3,18,14,11,7,0,10,11,90.9,1,23,5,18,15,33,54,0,21/22
Takehiro Tomiyasu,jp JPN,DF,Arsenal,22,1998,18.7,35,17,19,13,3,21,32,65.6,11,22,3,19,24,59,64,2,21/22
James Tomkins,eng ENG,DF,Crystal Palace,32,1989,6.1,8,3,6,2,0,6,8,75,2,8,8,0,4,12,18,0,21/22
Ivan Toney,eng ENG,FW,Brentford,25,1996,32.3,33,21,5,20,8,12,38,31.6,26,16,2,14,14,47,44,1,21/22
Ferrán Torres,es ESP,FW,Manchester City,21,2000,3.4,2,2,0,1,1,0,3,0,3,2,0,2,0,2,1,0,21/22
Cenk Tosun,tr TUR,MF,Everton,30,1991,0.1,0,0,0,0,0,0,0,,0,0,0,0,0,0,0,0,21/22
Andros Townsend,eng ENG,MFFW,Everton,30,1991,16.2,31,17,15,6,10,15,40,37.5,25,28,2,26,14,45,6,1,21/22
Adama Traoré,es ESP,FWMF,Wolves,25,1996,11.9,8,3,6,0,2,3,7,42.9,4,4,1,3,2,10,1,0,21/22
Bertrand Traoré,bf BFA,MFFW,Aston Villa,25,1995,2.4,3,3,0,1,2,1,2,50,1,0,0,0,0,3,1,0,21/22
Trézéguet,eg EGY,FW,Aston Villa,26,1994,0.1,0,0,0,0,0,0,0,,0,0,0,0,0,0,0,0,21/22
Francisco Trincão,pt POR,FWMF,Wolves,21,1999,14.8,28,15,9,13,6,3,19,15.8,16,17,1,16,12,40,1,1,21/22
Kieran Trippier,eng ENG,DF,Newcastle Utd,30,1990,4.8,17,10,8,8,1,10,16,62.5,6,10,3,7,10,27,10,0,21/22
William Troost-Ekong,ng NGA,DF,Watford,27,1993,15.4,18,9,11,6,1,10,15,66.7,5,24,14,10,7,25,82,1,21/22
Leandro Trossard,be BEL,FWMF,Brighton,26,1994,31.2,34,20,12,9,13,4,31,12.9,27,33,4,29,15,49,10,0,21/22
Kostas Tsimikas,gr GRE,DF,Liverpool,25,1996,9.7,27,12,12,8,7,12,16,75,4,6,2,4,10,37,22,2,21/22
Axel Tuanzebe,eng ENG,DF,Aston Villa,23,1997,5.6,5,3,3,2,0,2,5,40,3,5,4,1,5,10,12,1,21/22
Ozan Tufan,tr TUR,MF,Watford,26,1995,3.7,3,2,1,1,1,1,5,20,4,2,0,2,2,5,4,0,21/22
Christos Tzolis,gr GRE,FWMF,Norwich City,19,2002,3.7,5,3,3,1,1,2,9,22.2,7,3,0,3,1,6,1,0,21/22
Yan Valery,tn TUN,DF,Southampton,22,1999,4.1,8,6,4,3,1,4,9,44.4,5,6,3,3,6,14,19,1,21/22
Virgil van Dijk,nl NED,DF,Liverpool,30,1991,34,16,10,11,5,0,11,16,68.8,5,21,14,7,31,47,109,0,21/22
Raphaël Varane,fr FRA,DF,Manchester Utd,28,1993,20.3,28,19,21,6,1,10,22,45.5,12,18,9,9,18,46,82,1,21/22
Jamie Vardy,eng ENG,FW,Leicester City,34,1987,20.1,6,5,0,4,2,1,7,14.3,6,9,0,9,1,7,17,0,21/22
Joël Veltman,nl NED,DF,Brighton,29,1992,31.9,74,48,47,21,6,21,53,39.6,32,46,16,30,45,119,89,0,21/22
Jannik Vestergaard,dk DEN,DF,Leicester City,28,1992,6.3,15,10,12,3,0,8,15,53.3,7,10,8,2,7,22,36,0,21/22
Nikola Vlašić,hr CRO,FWMF,West Ham,23,1997,6.2,11,7,4,6,1,5,20,25,15,4,0,4,2,13,1,0,21/22
Matěj Vydra,cz CZE,FW,Burnley,29,1992,7.5,12,7,3,4,5,3,7,42.9,4,5,1,4,0,12,9,0,21/22
Theo Walcott,eng ENG,MFFW,Southampton,32,1989,4.2,4,2,2,0,2,1,5,20,4,3,0,3,5,9,2,0,21/22
Kyle Walker,eng ENG,DF,Manchester City,31,1990,19.5,15,6,7,7,1,8,17,47.1,9,14,4,10,14,29,16,1,21/22
Kyle Walker-Peters,eng ENG,DF,Southampton,24,1997,29.3,57,33,28,21,8,26,38,68.4,12,29,8,21,37,94,53,1,21/22
Aaron Wan-Bissaka,eng ENG,DF,Manchester Utd,23,1997,19.9,49,36,25,18,6,14,20,70,6,24,14,10,34,83,41,2,21/22
Danny Ward,wls WAL,GK,Leicester City,28,1993,1,0,0,0,0,0,0,0,,0,0,0,0,0,0,1,0,21/22
Joel Ward,eng ENG,DF,Crystal Palace,31,1989,27.6,44,26,30,11,3,30,57,52.6,27,24,11,13,32,76,107,1,21/22
James Ward-Prowse,eng ENG,MF,Southampton,26,1994,35.7,41,24,12,24,5,19,70,27.1,51,43,15,28,40,81,45,1,21/22
Ollie Watkins,eng ENG,FW,Aston Villa,25,1995,32.8,17,13,2,7,8,2,15,13.3,13,25,3,22,12,29,27,0,21/22
Adam Webster,eng ENG,DF,Brighton,26,1995,15.9,26,8,17,7,2,13,20,65,7,25,17,8,17,43,66,2,21/22
Wout Weghorst,nl NED,FW,Burnley,28,1992,16.1,17,9,3,9,5,6,19,31.6,13,16,5,11,6,23,13,0,21/22
Danny Welbeck,eng ENG,FWMF,Brighton,30,1990,16.4,14,7,2,8,4,3,10,30,7,18,2,16,5,19,18,0,21/22
Timo Werner,de GER,FWMF,Chelsea,25,1996,14.3,8,4,3,3,2,2,20,10,18,9,0,9,2,10,4,0,21/22
Ashley Westwood,eng ENG,MF,Burnley,31,1990,25.4,21,12,8,12,1,10,31,32.3,21,21,9,12,30,51,16,1,21/22
Ben White,eng ENG,DF,Arsenal,23,1997,32,44,23,30,8,6,28,45,62.2,17,42,24,18,42,86,102,0,21/22
Brandon Williams,eng ENG,DF,Norwich City,20,2000,23.6,55,37,35,18,2,36,64,56.3,28,26,6,20,44,99,50,0,21/22
Neco Williams,wls WAL,DF,Liverpool,20,2001,0.1,0,0,0,0,0,0,0,,0,0,0,0,0,0,0,0,21/22
Joe Willock,eng ENG,MF,Newcastle Utd,21,1999,22.6,64,37,30,28,6,29,68,42.6,39,37,6,31,21,85,10,1,21/22
Callum Wilson,eng ENG,FW,Newcastle Utd,29,1992,15.4,9,8,1,5,3,1,4,25,3,7,2,5,3,12,10,0,21/22
Harry Winks,eng ENG,MF,Tottenham,25,1996,10.1,15,10,4,9,2,8,21,38.1,13,14,3,11,16,31,10,2,21/22
Yoane Wissa,cd COD,FW,Brentford,24,1996,14.3,12,6,5,4,3,1,16,6.3,15,12,5,7,8,20,6,0,21/22
Chris Wood,nz NZL,FW,Burnley,29,1991,15.2,7,5,0,3,4,3,10,30,7,13,4,9,0,7,3,0,21/22
Chris Wood,nz NZL,FW,Newcastle Utd,29,1991,14.7,2,0,1,1,0,1,2,50,1,5,2,3,2,4,9,0,21/22
Freddie Woodman,eng ENG,GK,Newcastle Utd,24,1997,4,0,0,0,0,0,0,0,,0,0,0,0,0,0,0,1,21/22
Granit Xhaka,ch SUI,MFDF,Arsenal,28,1992,25.9,32,18,16,12,4,16,41,39,25,21,6,15,21,53,31,0,21/22
Andriy Yarmolenko,ua UKR,FWMF,West Ham,31,1989,3.5,4,2,2,2,0,2,8,25,6,4,2,2,0,4,2,0,21/22
Ashley Young,eng ENG,DFFW,Aston Villa,36,1985,13.9,18,6,9,6,3,11,16,68.8,5,10,4,6,13,31,25,1,21/22
Nathan Young-Coombes,eng ENG,MF,Brentford,18,2003,0,0,0,0,0,0,0,0,,0,0,0,0,0,0,0,0,21/22
Wilfried Zaha,ci CIV,FW,Crystal Palace,28,1992,30.7,40,20,14,15,11,10,31,32.3,21,28,0,28,5,45,5,0,21/22
Christoph Zimmermann,de GER,DF,Norwich City,28,1993,1.7,6,3,5,1,0,3,4,75,1,0,0,0,1,7,4,0,21/22
Oleksandr Zinchenko,ua UKR,DF,Manchester City,24,1996,11.6,20,14,7,10,3,11,20,55,9,11,3,8,14,34,15,1,21/22
Hakim Ziyech,ma MAR,MFFW,Chelsea,28,1993,14.7,19,10,5,12,2,10,36,27.8,26,11,1,10,10,29,10,0,21/22
Kurt Zouma,fr FRA,DF,West Ham,26,1994,23.1,11,6,8,3,0,4,7,57.1,3,31,26,5,34,45,132,0,21/22
Martin Ødegaard,no NOR,MFFW,Arsenal,22,1998,30.9,49,21,6,24,19,22,61,36.1,39,18,1,17,11,60,11,1,21/22
Patrick van Aanholt,nl NED,DF,Crystal Palace,29,1990,19.7,35,22,18,17,0,19,43,44.2,24,18,6,12,30,65,40,2,20/21
Tammy Abraham,eng ENG,FW,Chelsea,22,1997,11.6,7,5,3,3,1,1,7,14.3,6,6,0,6,5,12,17,0,20/21
Che Adams,sct SCO,FW,Southampton,24,1996,29.6,25,16,4,15,6,6,17,35.3,11,20,2,18,4,29,19,1,20/21
Tosin Adarabioyo,eng ENG,DF,Fulham,22,1997,32.8,37,19,30,6,1,19,40,47.5,21,26,20,6,42,79,197,2,20/21
Adrián,es ESP,GK,Liverpool,33,1987,3,0,0,0,0,0,0,0,,0,0,0,0,0,0,3,1,20/21
Sergio Agüero,ar ARG,FW,Manchester City,32,1988,6.2,4,1,0,2,2,2,11,18.2,9,2,0,2,2,6,0,0,20/21
Ola Aina,ng NGA,DF,Fulham,23,1996,29.6,37,20,22,7,8,21,43,48.8,22,22,6,16,45,82,94,2,20/21
Rayan Aït Nouri,dz ALG,DF,Wolves,19,2001,15.6,29,16,18,10,1,13,27,48.1,14,14,1,13,15,44,25,0,20/21
Semi Ajayi,ng NGA,DF,West Brom,26,1993,30.9,40,14,34,6,0,23,41,56.1,18,51,32,19,42,82,122,2,20/21
Nathan Aké,nl NED,DF,Manchester City,25,1995,8.9,10,5,3,6,1,3,4,75,1,2,1,1,9,19,23,0,20/21
Marc Albrighton,eng ENG,DFFW,Leicester City,30,1989,19.4,33,19,14,15,4,16,45,35.6,29,29,3,26,17,50,27,1,20/21
Thiago Alcántara,es ESP,MF,Liverpool,29,1991,20.6,61,36,20,30,11,17,49,34.7,32,26,0,26,30,91,14,0,20/21
Toby Alderweireld,be BEL,DF,Tottenham,31,1989,24.9,35,22,22,11,2,18,30,60,12,40,28,12,10,45,121,0,20/21
Rúnar Alex Rúnarsson,is ISL,GK,Arsenal,25,1995,0.2,0,0,0,0,0,0,0,,0,0,0,0,0,0,0,0,20/21
Trent Alexander-Arnold,eng ENG,DF,Liverpool,21,1998,33.7,56,33,31,18,7,36,56,64.3,20,24,3,21,49,105,50,3,20/21
Ezgjan Alioski,mk MKD,DFMF,Leeds United,28,1992,27.3,74,31,38,28,8,32,74,43.2,42,17,2,15,23,97,50,2,20/21
Alisson,br BRA,GK,Liverpool,27,1992,33,3,2,3,0,0,3,4,75,1,0,0,0,2,5,26,7,20/21
Allan,br BRA,MF,Everton,29,1991,22.8,80,45,39,37,4,28,95,29.5,67,31,12,19,19,99,25,1,20/21
Dele Alli,eng ENG,MF,Tottenham,24,1996,6.9,18,11,8,6,4,7,19,36.8,12,9,0,9,7,25,3,0,20/21
Miguel Almirón,py PAR,MFFW,Newcastle Utd,26,1994,27,49,29,21,25,3,14,56,25,42,23,4,19,25,74,20,1,20/21
Marcos Alonso,es ESP,DF,Chelsea,29,1990,10.7,13,3,6,4,3,7,14,50,7,12,1,11,12,25,30,0,20/21
Steven Alzate,co COL,MF,Brighton,21,1998,10,17,8,10,4,3,6,15,40,9,8,1,7,8,25,10,0,20/21
Daniel Amartey,gh GHA,DF,Leicester City,25,1994,8,11,7,6,4,1,8,12,66.7,4,8,4,4,12,23,26,0,20/21
Ethan Ampadu,wls WAL,DFMF,Sheffield Utd,19,2000,23.2,57,36,31,24,2,20,46,43.5,26,40,19,21,49,106,87,3,20/21
Joachim Andersen,dk DEN,DF,Fulham,24,1996,30.3,33,19,18,11,4,15,28,53.6,13,24,13,11,44,77,151,1,20/21
Elliot Anderson,sct SCO,MF,Newcastle Utd,17,2002,0,0,0,0,0,0,0,0,,0,0,0,0,0,0,0,0,20/21
Felipe Anderson,br BRA,FWMF,West Ham,27,1993,0,1,1,0,1,0,0,0,,0,0,0,0,0,1,0,0,20/21
Michail Antonio,jm JAM,FW,West Ham,30,1990,21.9,7,4,1,5,1,1,7,14.3,6,20,3,17,7,14,7,0,20/21
Alphonse Areola,fr FRA,GK,Fulham,27,1993,36,1,0,1,0,0,1,5,20,4,0,0,0,1,2,13,3,20/21
Stuart Armstrong,sct SCO,MF,Southampton,28,1992,30.7,60,41,19,32,9,27,75,36,48,26,1,25,24,84,19,0,20/21
Kepa Arrizabalaga,es ESP,GK,Chelsea,25,1994,6.5,0,0,0,0,0,0,1,0,1,0,0,0,0,0,0,3,20/21
Pierre-Emerick Aubameyang,ga GAB,FW,Arsenal,31,1989,25.9,12,8,7,4,1,3,20,15,17,18,0,18,7,19,17,0,20/21
Serge Aurier,ci CIV,DF,Tottenham,27,1992,17.8,55,33,33,17,5,15,40,37.5,25,28,5,23,19,74,44,3,20/21
Charlie Austin,eng ENG,FWMF,West Brom,31,1989,1.5,4,2,1,2,1,1,3,33.3,2,0,0,0,3,7,4,0,20/21
Jordan Ayew,gh GHA,FWMF,Crystal Palace,28,1991,23.3,38,26,8,16,14,16,44,36.4,28,28,2,26,16,54,12,0,20/21
Luke Ayling,eng ENG,DF,Leeds United,28,1991,37.8,108,61,69,30,9,49,87,56.3,38,53,36,17,36,144,96,5,20/21
César Azpilicueta,es ESP,DF,Chelsea,30,1989,24.3,53,28,22,24,7,19,37,51.4,18,30,5,25,28,81,62,2,20/21
Eric Bailly,ci CIV,DF,Manchester Utd,26,1994,10.2,5,5,3,1,1,0,1,0,1,13,11,2,13,18,36,2,20/21
Fabián Balbuena,py PAR,DF,West Ham,28,1991,13.3,24,12,23,1,0,14,23,60.9,9,23,6,17,25,49,63,0,20/21
George Baldock,gr GRE,DF,Sheffield Utd,27,1993,31,47,34,28,14,5,21,50,42,29,26,7,19,25,72,70,1,20/21
Gareth Bale,wls WAL,FW,Tottenham,31,1989,10.2,17,10,4,9,4,7,14,50,7,13,2,11,8,25,16,0,20/21
Patrick Bamford,eng ENG,FW,Leeds United,26,1993,33.9,21,9,2,11,8,8,27,29.6,19,14,4,10,10,31,37,0,20/21
Phil Bardsley,sct SCO,DF,Burnley,35,1985,3,6,5,4,2,0,3,6,50,3,3,1,2,6,12,12,0,20/21
Ross Barkley,eng ENG,MF,Aston Villa,26,1993,17,6,2,2,4,0,3,15,20,12,9,1,8,5,11,6,1,20/21
Ross Barkley,eng ENG,FWMF,Chelsea,26,1993,0.5,0,0,0,0,0,0,0,,0,0,0,0,0,0,0,0,20/21
Ashley Barnes,eng ENG,FW,Burnley,30,1989,14.8,12,6,2,6,4,3,13,23.1,10,14,2,12,5,17,11,0,20/21
Harvey Barnes,eng ENG,FWMF,Leicester City,22,1997,21.6,19,9,11,3,5,5,22,22.7,17,16,3,13,8,27,11,0,20/21
Kyle Bartley,eng ENG,DF,West Brom,29,1991,28.7,27,16,14,10,3,11,23,47.8,12,50,35,15,38,65,159,1,20/21
Chris Basham,eng ENG,DFMF,Sheffield Utd,32,1988,28.6,69,42,41,23,5,41,67,61.2,26,36,15,21,49,118,105,1,20/21
Michy Batshuayi,be BEL,FW,Crystal Palace,26,1993,8.1,5,3,1,2,2,1,9,11.1,8,5,1,4,4,9,5,0,20/21
Jan Bednarek,pl POL,DF,Southampton,24,1996,34.4,37,19,25,11,1,25,49,51,24,44,27,17,84,121,132,0,20/21
Donny van de Beek,nl NED,MFFW,Manchester Utd,23,1997,5.8,15,10,2,11,2,7,15,46.7,8,10,1,9,6,21,7,0,20/21
Héctor Bellerín,es ESP,DFMF,Arsenal,25,1995,23.2,29,19,14,12,3,12,41,29.3,29,26,8,18,33,62,33,0,20/21
Saïd Benrahma,dz ALG,FWMF,West Ham,24,1995,15.5,24,15,8,11,5,8,28,28.6,20,10,0,10,8,32,8,0,20/21
Josh Benson,eng ENG,MF,Burnley,20,1999,2.9,5,1,3,0,2,1,6,16.7,5,3,0,3,3,8,2,0,20/21
Christian Benteke,be BEL,FW,Crystal Palace,29,1990,20.2,15,7,1,7,7,2,9,22.2,7,17,6,11,4,19,39,0,20/21
Gaetano Berardi,ch SUI,DF,Leeds United,31,1988,1.3,2,2,1,0,1,0,0,,0,2,1,1,1,3,2,0,20/21
Jóhann Berg Guðmundsson,is ISL,MF,Burnley,29,1990,15.1,19,11,6,9,4,11,23,47.8,12,11,2,9,17,36,19,0,20/21
Sander Berge,no NOR,MF,Sheffield Utd,22,1998,12.4,16,7,8,5,3,7,15,46.7,8,11,2,9,4,20,18,0,20/21
Steven Bergwijn,nl NED,FWMF,Tottenham,22,1997,13.4,15,7,8,3,4,7,20,35,13,7,1,6,5,20,9,0,20/21
Bernard,br BRA,MFFW,Everton,27,1992,5.1,8,3,3,3,2,7,15,46.7,8,5,0,5,8,16,6,0,20/21
Bernardo,br BRA,DFMF,Brighton,25,1995,2.3,10,8,8,1,1,4,6,66.7,2,2,0,2,1,11,1,0,20/21
Ryan Bertrand,eng ENG,DF,Southampton,30,1989,28.9,60,32,26,27,7,30,48,62.5,18,19,1,18,30,90,41,1,20/21
Yves Bissouma,ml MLI,MF,Brighton,23,1996,34.6,104,68,50,48,6,33,67,49.3,34,42,6,36,64,168,67,0,20/21
Jayden Bogle,eng ENG,DFMF,Sheffield Utd,20,2000,12.3,33,23,21,10,2,20,39,51.3,19,14,4,10,14,47,22,0,20/21
Willy Boly,ci CIV,DF,Wolves,29,1991,20.9,33,20,26,7,0,13,24,54.2,11,18,12,6,32,65,84,1,20/21
Jarrod Bowen,eng ENG,FWMF,West Ham,23,1996,28.5,26,15,12,7,7,10,29,34.5,19,19,1,18,22,48,10,0,20/21
Robbie Brady,ie IRL,MF,Burnley,28,1992,11.7,22,15,12,6,4,12,35,34.3,23,16,0,16,9,31,29,1,20/21
Rhian Brewster,eng ENG,FWMF,Sheffield Utd,20,2000,12.5,8,5,1,4,3,1,13,7.7,12,15,2,13,5,13,5,0,20/21
Nathan Broadhead,wls WAL,FW,Everton,22,1998,0,1,1,0,1,0,0,0,,0,0,0,0,0,1,0,0,20/21
Josh Brownhill,eng ENG,MF,Burnley,24,1995,31.3,45,27,9,29,7,15,44,34.1,29,33,11,22,69,114,39,0,20/21
Joe Bryan,eng ENG,DFMF,Fulham,26,1993,7.4,15,8,7,5,3,7,12,58.3,5,8,2,6,14,29,16,0,20/21
Kean Bryan,eng ENG,DF,Sheffield Utd,23,1996,11.2,20,10,9,11,0,9,19,47.4,10,16,10,6,13,33,39,1,20/21
Oliver Burke,sct SCO,FW,Sheffield Utd,23,1997,14.1,16,8,6,9,1,5,24,20.8,19,24,0,24,2,18,6,0,20/21
Dan Burn,eng ENG,DF,Brighton,28,1992,22.9,50,26,33,14,3,27,53,50.9,26,30,7,23,31,81,75,0,20/21
Jack Butland,eng ENG,GK,Crystal Palace,27,1993,1,0,0,0,0,0,0,0,,0,0,0,0,0,0,0,0,20/21
David Button,eng ENG,GK,West Brom,31,1989,1,0,0,0,0,0,0,0,,0,0,0,0,0,0,0,0,20/21
Oskar Buur,dk DEN,DF,Wolves,22,1998,0.2,0,0,0,0,0,0,2,0,2,0,0,0,0,0,0,0,20/21
Willy Caballero,ar ARG,GK,Chelsea,38,1981,1,0,0,0,0,0,0,0,,0,0,0,0,0,0,0,0,20/21
Gary Cahill,eng ENG,DF,Crystal Palace,34,1985,20,13,9,10,3,0,7,11,63.6,4,27,22,5,13,26,88,0,20/21
Tom Cairney,sct SCO,MF,Fulham,29,1991,8.4,9,3,1,4,4,1,4,25,3,6,0,6,0,9,3,0,20/21
Dominic Calvert-Lewin,eng ENG,FW,Everton,23,1997,31.9,17,8,1,8,8,6,12,50,6,22,6,16,6,23,33,0,20/21
João Cancelo,pt POR,DFMF,Manchester City,26,1994,25.5,68,41,42,19,7,43,83,51.8,40,23,2,21,41,109,33,2,20/21
Ian Carlo Poveda,eng ENG,MF,Leeds United,20,2000,3.9,5,4,3,0,2,1,7,14.3,6,5,1,4,1,6,2,0,20/21
Andy Carroll,eng ENG,FW,Newcastle Utd,31,1989,4.4,3,1,1,1,1,1,8,12.5,7,1,0,1,0,3,14,0,20/21
Scott Carson,eng ENG,GK,Manchester City,34,1985,1,0,0,0,0,0,0,0,,0,0,0,0,0,0,0,0,20/21
Fabio Carvalho,pt POR,MFFW,Fulham,17,2002,2.8,9,6,4,4,1,5,9,55.6,4,2,0,2,1,10,1,1,20/21
Matty Cash,pl POL,DF,Aston Villa,22,1997,26.4,71,40,43,22,6,41,74,55.4,33,50,11,39,60,131,95,0,20/21
Kiko Casilla,es ESP,GK,Leeds United,33,1986,3,0,0,0,0,0,0,0,,0,0,0,0,0,0,0,0,20/21
Timothy Castagne,be BEL,DF,Leicester City,24,1995,26.1,52,32,29,18,5,24,44,54.5,20,29,5,24,29,81,62,1,20/21
Jonny Castro,es ESP,MFDF,Wolves,26,1994,5.5,11,5,6,4,1,6,13,46.2,7,9,3,6,9,20,7,0,20/21
Ivan Cavaleiro,pt POR,FW,Fulham,26,1993,27.5,23,14,9,11,3,12,34,35.3,22,25,1,24,19,42,14,0,20/21
Edinson Cavani,uy URU,FW,Manchester Utd,33,1987,15.3,12,8,1,8,3,2,13,15.4,11,2,0,2,6,18,11,0,20/21
Dani Ceballos,es ESP,MF,Arsenal,23,1996,17.9,37,22,20,11,6,21,51,41.2,30,23,6,17,35,72,14,1,20/21
Calum Chambers,eng ENG,DF,Arsenal,25,1995,8.4,7,3,3,2,2,3,8,37.5,5,6,2,4,10,17,37,0,20/21
Ben Chilwell,eng ENG,DF,Chelsea,23,1996,25.4,42,22,16,22,4,15,33,45.5,18,28,3,25,24,66,58,0,20/21
Hamza Choudhury,eng ENG,MF,Leicester City,22,1997,3.5,8,7,3,5,0,4,10,40,6,4,1,3,4,12,9,1,20/21
Andreas Christensen,dk DEN,DF,Chelsea,24,1996,15.2,11,6,8,3,0,0,8,0,8,19,14,5,20,31,51,1,20/21
Carney Chukwuemeka,eng ENG,MFFW,Aston Villa,16,2003,0.2,2,2,1,0,1,1,3,33.3,2,0,0,0,0,2,0,0,20/21
Ciaran Clark,ie IRL,DF,Newcastle Utd,30,1989,21,24,14,15,6,3,6,13,46.2,7,27,20,7,29,53,104,1,20/21
Nathaniel Clyne,eng ENG,DF,Crystal Palace,29,1991,12.7,17,10,8,8,1,9,16,56.3,7,7,2,5,18,35,25,1,20/21
Conor Coady,eng ENG,DF,Wolves,27,1993,36.7,35,23,25,10,0,19,35,54.3,16,40,32,8,27,62,134,2,20/21
Séamus Coleman,ie IRL,DFMF,Everton,31,1988,17.9,39,26,21,14,4,21,30,70,9,22,6,16,13,52,37,2,20/21
Aaron Connolly,ie IRL,FW,Brighton,20,2000,8.8,6,3,1,3,2,0,2,0,2,4,0,4,0,6,2,0,20/21
Liam Cooper,sct SCO,DF,Leeds United,28,1991,24.3,68,45,39,27,2,37,59,62.7,22,39,32,7,61,129,70,1,20/21
Theo Corbeanu,ca CAN,FW,Wolves,18,2002,0.1,2,1,0,2,0,1,1,100,0,0,0,0,1,3,0,0,20/21
Jack Cork,eng ENG,MF,Burnley,31,1989,15,26,10,5,17,4,11,31,35.5,20,15,4,11,16,42,20,0,20/21
Hélder Costa,ao ANG,MFFW,Leeds United,26,1994,12.8,25,11,12,5,8,11,32,34.4,21,11,0,11,3,28,5,1,20/21
Vladimír Coufal,cz CZE,DF,West Ham,27,1992,33.9,73,36,50,15,8,52,89,58.4,37,41,7,34,41,114,102,1,20/21
Aaron Cresswell,eng ENG,DF,West Ham,30,1989,35.2,32,13,15,15,2,18,32,56.3,14,29,14,15,32,64,79,2,20/21
Patrick Cutrone,it ITA,FW,Wolves,22,1998,0.3,0,0,0,0,0,0,0,,0,0,0,0,0,0,0,0,20/21
Stuart Dallas,nir NIR,MFDF,Leeds United,29,1991,37.9,74,45,46,22,6,30,88,34.1,58,41,3,38,44,118,52,1,20/21
Scott Dann,eng ENG,DF,Crystal Palace,33,1987,15,6,4,5,1,0,4,11,36.4,7,16,14,2,18,24,59,1,20/21
Karl Darlow,eng ENG,GK,Newcastle Utd,29,1990,25,0,0,0,0,0,0,0,,0,0,0,0,0,0,17,0,20/21
Ben Davies,wls WAL,DF,Tottenham,27,1993,15,27,17,10,11,6,13,30,43.3,17,10,5,5,18,45,49,2,20/21
Tom Davies,eng ENG,MF,Everton,22,1998,15.8,31,18,17,12,2,16,39,41,23,15,9,6,34,65,21,2,20/21
Keinan Davis,eng ENG,FWMF,Aston Villa,22,1998,3.1,2,1,1,0,1,0,1,0,1,1,0,1,0,2,2,0,20/21
Leif Davis,eng ENG,DF,Leeds United,20,2000,0.4,0,0,0,0,0,0,3,0,3,1,0,1,1,1,0,0,20/21
Craig Dawson,eng ENG,DF,West Ham,30,1990,21.4,11,8,7,4,0,5,12,41.7,7,26,22,4,32,43,88,3,20/21
Kevin De Bruyne,be BEL,MF,Manchester City,29,1991,22.2,34,21,6,18,10,13,48,27.1,35,26,1,25,9,43,10,0,20/21
Liam Delap,eng ENG,FW,Manchester City,17,2003,0.4,0,0,0,0,0,0,0,,0,0,0,0,0,0,0,0,20/21
Fabian Delph,eng ENG,MFDF,Everton,30,1989,3,5,2,3,2,0,1,3,33.3,2,2,0,2,4,9,8,1,20/21
Leander Dendoncker,be BEL,MFDF,Wolves,25,1995,27.8,54,29,29,22,3,31,60,51.7,29,38,15,23,27,81,52,2,20/21
Mbaye Diagne,sn SEN,FW,West Brom,28,1991,13.2,4,3,3,0,1,1,4,25,3,2,1,1,1,5,16,0,20/21
Amad Diallo,ci CIV,FW,Manchester Utd,18,2002,1.8,3,3,1,2,0,0,0,,0,2,1,1,0,3,1,0,20/21
Ibrahima Diallo,fr FRA,MF,Southampton,21,1999,11.3,29,16,11,17,1,9,16,56.3,7,10,1,9,10,39,12,2,20/21
Grady Diangana,eng ENG,MFFW,West Brom,22,1998,13.7,35,19,19,9,7,19,43,44.2,24,16,2,14,16,51,9,0,20/21
Rúben Dias,pt POR,DF,Manchester City,23,1997,31.6,24,13,13,8,3,4,16,25,12,31,23,8,35,59,92,0,20/21
Eric Dier,eng ENG,DF,Tottenham,26,1994,28,23,14,13,10,0,11,18,61.1,7,37,31,6,23,46,123,3,20/21
Lucas Digne,fr FRA,DFMF,Everton,27,1993,29.8,63,38,40,16,7,29,54,53.7,25,42,4,38,31,94,87,0,20/21
Issa Diop,fr FRA,DF,West Ham,23,1997,15.3,20,14,12,8,0,7,18,38.9,11,32,22,10,22,42,59,0,20/21
Moussa Djenepo,ml MLI,MF,Southampton,22,1998,13.8,52,27,27,17,8,28,63,44.4,35,24,2,22,10,62,14,0,20/21
Matt Doherty,ie IRL,DF,Tottenham,28,1992,13.8,29,15,15,10,4,13,33,39.4,20,20,5,15,23,52,46,0,20/21
Gabriel Dos Santos,br BRA,DF,Arsenal,22,1997,22.2,25,15,19,5,1,13,19,68.4,6,27,19,8,26,51,74,2,20/21
Abdoulaye Doucouré,ml MLI,MF,Everton,27,1993,27.1,52,32,25,19,8,14,43,32.6,29,24,7,17,39,91,31,1,20/21
Martin Dúbravka,sk SVK,GK,Newcastle Utd,31,1989,13,0,0,0,0,0,0,0,,0,0,0,0,0,0,3,0,20/21
Paul Dummett,wls WAL,DF,Newcastle Utd,28,1991,13.9,16,7,11,5,0,13,21,61.9,8,12,7,5,16,32,74,0,20/21
Lewis Dunk,eng ENG,DF,Brighton,28,1991,32.6,30,15,20,8,2,16,23,69.6,7,29,20,9,32,62,106,0,20/21
Jimmy Dunne,ie IRL,DF,Burnley,22,1997,3,3,3,2,1,0,1,2,50,1,3,2,1,6,9,16,1,20/21
Ederson,br BRA,GK,Manchester City,26,1993,36,3,1,3,0,0,3,4,75,1,0,0,0,0,3,11,4,20/21
Kyle Edwards,eng ENG,MFFW,West Brom,22,1998,1.3,3,2,1,1,1,0,0,,0,2,0,2,1,4,0,0,20/21
John Egan,ie IRL,DF,Sheffield Utd,27,1992,29.2,41,21,29,12,0,22,39,56.4,17,43,31,12,41,82,131,0,20/21
Anthony Elanga,se SWE,FW,Manchester Utd,18,2002,1.7,4,2,3,1,0,4,5,80,1,1,1,0,1,5,1,0,20/21
Ahmed Elmohamady,eg EGY,DF,Aston Villa,32,1987,9.3,17,13,12,4,1,9,14,64.3,5,6,3,3,17,34,26,0,20/21
Mohamed Elneny,eg EGY,MF,Arsenal,28,1992,17.2,14,6,7,7,0,7,28,25,21,11,4,7,24,38,20,2,20/21
Jonny Evans,nir NIR,DF,Leicester City,32,1988,27.5,25,12,22,2,1,14,20,70,6,8,3,5,46,71,98,1,20/21
Eberechi Eze,eng ENG,MF,Crystal Palace,22,1998,28.4,27,14,11,13,3,16,35,45.7,19,19,3,16,24,51,9,1,20/21
Łukasz Fabiański,pl POL,GK,West Ham,35,1985,35,1,0,1,0,0,1,1,100,0,1,0,1,1,2,12,3,20/21
Fabinho,br BRA,DFMF,Liverpool,26,1993,28.5,58,31,21,29,8,27,54,50,27,28,10,18,44,102,66,1,20/21
Bruno Fernandes,pt POR,MF,Manchester Utd,25,1994,34.4,57,30,16,29,12,26,100,26,74,38,0,38,26,83,29,0,20/21
Federico Fernández,ar ARG,DF,Newcastle Utd,31,1989,23.1,29,22,23,5,1,17,21,81,4,41,31,10,17,46,147,0,20/21
Fernandinho,br BRA,MF,Manchester City,35,1985,13.2,31,17,8,14,9,20,43,46.5,23,11,2,9,23,54,17,0,20/21
Sam Field,eng ENG,MF,West Brom,22,1998,0.7,5,5,3,2,0,0,0,,0,4,1,3,2,7,4,0,20/21
Roberto Firmino,br BRA,FW,Liverpool,28,1991,31.5,33,15,3,17,13,6,32,18.8,26,42,5,37,11,44,12,0,20/21
John Fleck,sct SCO,MF,Sheffield Utd,28,1991,28.6,51,33,28,18,5,26,83,31.3,57,26,4,22,28,79,12,1,20/21
Phil Foden,eng ENG,FWMF,Manchester City,20,2000,18,22,11,12,8,2,9,23,39.1,14,9,0,9,11,33,11,0,20/21
Wesley Fofana,fr FRA,DF,Leicester City,19,2000,25.1,51,37,27,22,2,31,46,67.4,15,28,16,12,61,112,94,0,20/21
Pablo Fornals,es ESP,FWMF,West Ham,24,1996,28.6,44,26,14,24,6,11,73,15.1,62,43,1,42,36,80,9,0,20/21
Fraser Forster,eng ENG,GK,Southampton,32,1988,8,1,0,1,0,0,1,2,50,1,0,0,0,0,1,9,0,20/21
Timothy Fosu-Mensah,nl NED,DF,Manchester Utd,22,1998,0.9,2,0,1,1,0,1,1,100,0,0,0,0,3,5,1,0,20/21
Tyrese Francois,au AUS,DF,Fulham,20,2000,0.2,0,0,0,0,0,0,0,,0,0,0,0,0,0,0,0,20/21
Ryan Fraser,sct SCO,FWMF,Newcastle Utd,26,1994,10.3,4,1,3,1,0,2,5,40,3,1,0,1,6,10,7,0,20/21
Fred,br BRA,MF,Manchester Utd,27,1993,26.6,81,39,39,38,4,29,89,32.6,60,49,9,40,45,126,26,1,20/21
Ryan Fredericks,eng ENG,DFFW,West Ham,27,1992,6.3,9,5,5,4,0,3,7,42.9,4,6,2,4,11,20,20,0,20/21
Christian Fuchs,at AUT,DF,Leicester City,34,1986,7.8,18,7,15,2,1,8,15,53.3,7,6,4,2,16,34,34,1,20/21
Darnell Furlong,eng ENG,DF,West Brom,24,1995,32.6,45,27,27,12,6,21,44,47.7,23,39,16,23,49,94,90,0,20/21
Conor Gallagher,eng ENG,MF,West Brom,20,2000,28.1,81,41,30,39,12,29,97,29.9,68,47,8,39,27,108,31,0,20/21
Eric García,es ESP,DF,Manchester City,19,2001,4.3,8,7,5,3,0,5,7,71.4,2,4,1,3,4,12,10,0,20/21
Dwight Gayle,eng ENG,FWMF,Newcastle Utd,29,1990,5.7,2,0,1,1,0,0,7,0,7,3,1,2,1,3,2,0,20/21
Jean-Philippe Gbamin,ci CIV,MF,Everton,24,1995,0.1,1,0,0,1,0,0,0,,0,1,0,1,0,1,1,0,20/21
David de Gea,es ESP,GK,Manchester Utd,29,1990,25.5,0,0,0,0,0,0,0,,0,0,0,0,0,0,8,3,20/21
Anwar El Ghazi,nl NED,FW,Aston Villa,25,1995,17.9,16,13,6,7,3,7,23,30.4,16,11,0,11,6,22,11,0,20/21
Kieran Gibbs,eng ENG,DF,West Brom,30,1989,9,15,11,11,3,1,8,10,80,2,8,6,2,16,31,30,1,20/21
Morgan Gibbs-White,eng ENG,MFFW,Wolves,20,2000,4.6,9,7,3,4,2,5,12,41.7,7,6,0,6,3,12,1,0,20/21
Billy Gilmour,sct SCO,MF,Chelsea,19,2001,2.9,4,2,1,2,1,2,7,28.6,5,3,2,1,3,7,1,0,20/21
Olivier Giroud,fr FRA,FW,Chelsea,33,1986,8.3,4,2,0,1,3,1,7,14.3,6,4,1,3,5,9,10,0,20/21
Ben Godfrey,eng ENG,DF,Everton,22,1998,29.8,55,33,37,15,3,27,41,65.9,14,56,37,19,33,88,120,0,20/21
André Gomes,pt POR,MF,Everton,27,1993,17.4,35,23,16,16,3,17,58,29.3,41,19,1,18,10,45,12,1,20/21
Joe Gomez,eng ENG,DF,Liverpool,23,1997,6.6,3,2,1,1,1,0,4,0,4,3,2,1,4,7,29,0,20/21
Anthony Gordon,eng ENG,FWMF,Everton,19,2001,1,3,3,3,0,0,0,2,0,2,1,0,1,1,4,3,0,20/21
Karlan Grant,eng ENG,FWMF,West Brom,22,1997,12.5,5,3,3,2,0,2,4,50,2,7,0,7,5,10,17,0,20/21
Demarai Gray,eng ENG,FW,Leicester City,24,1996,0.2,1,1,1,0,0,0,0,,0,0,0,0,0,1,0,0,20/21
Jack Grealish,eng ENG,FWMF,Aston Villa,24,1995,24.3,31,14,8,16,7,15,24,62.5,9,20,3,17,12,43,5,3,20/21
Mason Greenwood,eng ENG,FW,Manchester Utd,18,2001,20.2,13,10,6,4,3,5,22,22.7,17,9,0,9,5,18,1,0,20/21
Pascal Groß,de GER,MFDF,Brighton,29,1991,27.6,45,24,24,15,6,24,53,45.3,29,25,4,21,23,68,18,1,20/21
Kamil Grosicki,pl POL,MFFW,West Brom,32,1988,1.6,2,1,2,0,0,2,8,25,6,1,0,1,2,4,1,0,20/21
Vicente Guaita,es ESP,GK,Crystal Palace,33,1987,37,1,1,1,0,0,1,1,100,0,0,0,0,1,2,11,1,20/21
İlkay Gündoğan,de GER,MF,Manchester City,29,1990,22.5,25,15,8,12,5,10,39,25.6,29,13,4,9,20,45,9,0,20/21
Antwoine Hackford,eng ENG,DF,Sheffield Utd,16,2004,0.1,0,0,0,0,0,0,0,,0,0,0,0,0,0,0,0,20/21
Sébastien Haller,ci CIV,FW,West Ham,26,1994,10.4,14,9,1,6,7,4,20,20,16,7,1,6,5,19,7,0,20/21
Rekeem Harper,eng ENG,MF,West Brom,20,2000,0.4,0,0,0,0,0,0,0,,0,2,0,2,1,1,0,0,20/21
Jack Harrison,eng ENG,MFFW,Leeds United,23,1996,31.6,63,38,20,30,13,26,59,44.1,33,30,2,28,15,78,21,0,20/21
Kortney Hause,eng ENG,DF,Aston Villa,25,1995,7,4,2,3,1,0,0,3,0,3,4,2,2,8,12,53,0,20/21
Kai Havertz,de GER,MFFW,Chelsea,21,1999,16.9,18,9,6,10,2,6,27,22.2,21,25,0,25,4,22,22,1,20/21
Isaac Hayden,eng ENG,MFDF,Newcastle Utd,25,1995,21.6,52,29,23,22,7,14,35,40,21,32,9,23,43,95,47,0,20/21
Michael Hector,jm JAM,DF,Fulham,28,1992,2.9,3,2,1,2,0,1,6,16.7,5,4,2,2,0,3,6,0,20/21
Ahmed Hegazi,eg EGY,DF,West Brom,29,1991,1,0,0,0,0,0,0,0,,0,2,0,2,1,1,7,0,20/21
Dean Henderson,eng ENG,GK,Manchester Utd,23,1997,12.5,1,1,1,0,0,1,2,50,1,0,0,0,0,1,3,2,20/21
Jordan Henderson,eng ENG,MFDF,Liverpool,30,1990,18.9,24,15,12,9,3,10,26,38.5,16,12,1,11,34,58,30,0,20/21
Jeff Hendrick,ie IRL,MF,Newcastle Utd,28,1992,15.8,8,3,5,3,0,1,13,7.7,12,14,9,5,19,27,18,0,20/21
Pablo Hernández,es ESP,MF,Leeds United,35,1985,4.7,5,3,2,1,2,5,16,31.3,11,2,0,2,0,5,0,1,20/21
Son Heung-min,kr KOR,FW,Tottenham,28,1992,34.6,32,18,11,14,7,18,72,25,54,28,3,25,14,46,8,0,20/21
Ki-Jana Hoever,nl NED,DFMF,Wolves,18,2002,6.4,14,6,11,2,1,10,22,45.5,12,2,0,2,9,23,23,0,20/21
Rob Holding,eng ENG,DF,Arsenal,24,1995,28.4,43,20,28,13,2,17,35,48.6,18,37,27,10,24,67,120,0,20/21
Mason Holgate,eng ENG,DF,Everton,23,1996,25.4,56,36,31,18,7,20,50,40,30,37,13,24,35,91,90,3,20/21
Conor Hourihane,ie IRL,MF,Aston Villa,29,1991,2.5,0,0,0,0,0,0,2,0,2,3,0,3,0,0,2,0,20/21
Callum Hudson-Odoi,eng ENG,FWDF,Chelsea,19,2000,11.8,23,15,11,7,5,8,21,38.1,13,15,1,14,6,29,6,0,20/21
Niall Huggins,wls WAL,DF,Leeds United,19,2000,0.4,0,0,0,0,0,0,1,0,1,0,0,0,0,0,1,0,20/21
Pierre Højbjerg,dk DEN,MF,Tottenham,24,1995,38,98,51,45,42,11,54,129,41.9,75,51,9,42,48,146,66,0,20/21
Odion Ighalo,ng NGA,FW,Manchester Utd,31,1989,0.1,0,0,0,0,0,0,1,0,1,0,0,0,0,0,0,0,20/21
Kelechi Iheanacho,ng NGA,FW,Leicester City,23,1996,16.2,12,5,2,4,6,4,17,23.5,13,14,0,14,2,14,1,1,20/21
Danny Ings,eng ENG,FW,Southampton,28,1992,24.1,22,13,3,16,3,12,28,42.9,16,39,2,37,3,25,27,1,20/21
Branislav Ivanović,rs SRB,DF,West Brom,36,1984,8.5,14,5,11,3,0,7,13,53.8,6,11,5,6,8,22,25,0,20/21
Alex Iwobi,ng NGA,FWMF,Everton,24,1996,17.1,27,10,10,14,3,13,25,52,12,20,1,19,16,43,14,0,20/21
José Izquierdo,co COL,DF,Brighton,28,1992,0.1,0,0,0,0,0,0,0,,0,0,0,0,0,0,0,0,20/21
Phil Jagielka,eng ENG,DF,Sheffield Utd,37,1982,5.8,5,4,4,0,1,2,7,28.6,5,11,5,6,10,15,26,2,20/21
Alireza Jahanbakhsh,ir IRN,FWMF,Brighton,26,1993,5.9,9,7,3,5,1,2,12,16.7,10,8,0,8,8,17,1,0,20/21
Daniel James,wls WAL,FW,Manchester Utd,22,1997,10.1,15,9,4,7,4,3,18,16.7,15,10,1,9,0,15,6,0,20/21
Reece James,eng ENG,DF,Chelsea,20,1999,26.4,55,35,24,22,9,21,44,47.7,23,36,7,29,17,72,52,0,20/21
Alexandre Jankewitz,ch SUI,MF,Southampton,18,2001,0,2,1,2,0,0,1,1,100,0,0,0,0,0,2,0,0,20/21
Daniel Jebbison,eng ENG,FW,Sheffield Utd,17,2003,3.2,6,2,1,3,2,3,7,42.9,4,6,1,5,1,7,0,0,20/21
Gabriel Jesus,br BRA,FW,Manchester City,23,1997,22.9,17,6,5,5,7,11,28,39.3,17,16,0,16,15,32,5,0,20/21
Raúl Jiménez,mx MEX,FW,Wolves,29,1991,9.1,3,2,1,2,0,0,7,0,7,2,0,2,8,11,12,0,20/21
Joelinton,br BRA,FWMF,Newcastle Utd,23,1996,22,33,21,7,21,5,14,37,37.8,23,30,2,28,9,42,24,0,20/21
Ben Johnson,eng ENG,DFFW,West Ham,20,2000,5.8,11,5,5,3,3,7,9,77.8,2,5,1,4,11,22,9,0,20/21
Sam Johnstone,eng ENG,GK,West Brom,27,1993,37,0,0,0,0,0,0,0,,0,0,0,0,2,2,15,2,20/21
Curtis Jones,eng ENG,MF,Liverpool,19,2001,13.1,16,6,6,7,3,12,25,48,13,13,0,13,19,35,11,1,20/21
Jorginho,it ITA,MF,Chelsea,28,1991,22.3,57,30,22,31,4,31,76,40.8,45,33,5,28,40,97,21,3,20/21
Willian José,br BRA,FW,Wolves,28,1991,12.3,2,1,1,1,0,1,4,25,3,6,1,5,1,3,12,0,20/21
Diogo Jota,pt POR,FW,Liverpool,23,1996,12.4,12,6,4,7,1,2,29,6.9,27,9,0,9,5,17,3,0,20/21
James Justin,eng ENG,DF,Leicester City,22,1998,23,61,37,38,18,5,20,41,48.8,21,36,10,26,30,91,58,1,20/21
Ozan Kabak,tr TUR,DF,Liverpool,20,2000,8.9,19,10,11,4,4,6,9,66.7,3,2,2,0,12,31,28,1,20/21
Aboubakar Kamara,mr MTN,FWMF,Fulham,25,1995,3.5,2,2,1,1,0,0,5,0,5,6,0,6,1,3,0,0,20/21
Harry Kane,eng ENG,FW,Tottenham,27,1993,34.2,22,12,1,17,4,8,26,30.8,18,28,11,17,11,33,40,0,20/21
N'Golo Kanté,fr FRA,MF,Chelsea,29,1991,23.8,79,42,39,35,5,27,56,48.2,29,42,4,38,59,138,34,0,20/21
Moise Kean,it ITA,FWMF,Everton,20,2000,0.2,0,0,0,0,0,0,0,,0,0,0,0,0,0,0,0,20/21
Michael Keane,eng ENG,DF,Everton,27,1993,33.2,28,15,20,8,0,14,31,45.2,17,46,33,13,51,79,161,0,20/21
Neeskens Kebano,cd COD,FWMF,Fulham,28,1992,1.3,0,0,0,0,0,0,1,0,1,3,0,3,0,0,0,0,20/21
Naby Keïta,gn GUI,MF,Liverpool,25,1995,5.8,11,5,1,8,2,7,17,41.2,10,10,0,10,9,20,6,0,20/21
Caoimhín Kelleher,ie IRL,GK,Liverpool,21,1998,2,0,0,0,0,0,0,0,,0,0,0,0,0,0,2,0,20/21
Martin Kelly,eng ENG,DF,Crystal Palace,30,1990,0,1,0,1,0,0,1,1,100,0,0,0,0,0,1,0,0,20/21
Jonjoe Kenny,eng ENG,DF,Everton,23,1997,0.9,2,1,1,0,1,2,2,100,0,0,0,0,1,3,3,0,20/21
Reda Khadra,de GER,MF,Brighton,19,2001,0.1,0,0,0,0,0,0,0,,0,0,0,0,0,0,0,0,20/21
Max Kilman,eng ENG,DF,Wolves,23,1997,14.6,21,14,13,4,4,8,14,57.1,6,17,8,9,19,40,46,0,20/21
Joshua King,no NOR,MFFW,Everton,28,1992,1.6,4,1,2,1,1,0,0,,0,3,0,3,1,5,1,0,20/21
Mateusz Klich,pl POL,MF,Leeds United,30,1990,26.6,38,20,14,20,4,14,61,23,47,13,4,9,11,49,16,0,20/21
Robin Koch,de GER,DFMF,Leeds United,24,1996,12.6,27,16,17,10,0,10,19,52.6,9,18,12,6,27,54,34,2,20/21
Sead Kolašinac,ba BIH,DF,Arsenal,27,1993,1,0,0,0,0,0,0,0,,0,0,0,0,1,1,0,0,20/21
Terence Kongolo,nl NED,DF,Fulham,26,1994,1,3,2,1,2,0,1,1,100,0,0,0,0,2,5,3,0,20/21
Ezri Konsa,eng ENG,DF,Aston Villa,22,1997,35.5,25,13,18,6,1,9,13,69.2,4,53,47,6,29,54,162,1,20/21
Cheikhou Kouyaté,sn SEN,DF,Crystal Palace,30,1989,34.7,58,37,44,12,2,25,43,58.1,18,42,26,16,32,90,125,2,20/21
Mateo Kovačić,hr CRO,MF,Chelsea,26,1994,20.2,46,28,19,24,3,17,32,53.1,15,18,1,17,15,61,11,2,20/21
Emil Krafth,se SWE,DF,Newcastle Utd,25,1994,14.3,19,8,9,9,1,12,25,48,13,15,9,6,15,34,52,2,20/21
Filip Krovinović,hr CRO,MF,West Brom,24,1995,6.1,13,10,6,5,2,6,18,33.3,12,2,0,2,4,17,2,0,20/21
Alexandre Lacazette,fr FRA,FW,Arsenal,29,1991,21.4,18,10,4,11,3,4,22,18.2,18,20,1,19,12,30,13,0,20/21
Adam Lallana,eng ENG,MFFW,Brighton,32,1988,17.7,28,13,11,13,4,8,39,20.5,31,18,3,15,15,43,13,0,20/21
Érik Lamela,ar ARG,FWMF,Tottenham,28,1992,8,17,9,1,11,5,8,21,38.1,13,11,1,10,6,23,2,0,20/21
Tariq Lamptey,gh GHA,DFMF,Brighton,19,2000,9.8,17,9,7,6,4,6,13,46.2,7,8,1,7,19,36,12,1,20/21
Manuel Lanzini,ar ARG,MFFW,West Ham,27,1993,6.3,9,2,3,4,2,3,10,30,7,9,0,9,7,16,5,0,20/21
Aymeric Laporte,es ESP,DF,Manchester City,26,1994,14.9,13,6,10,3,0,7,11,63.6,4,12,7,5,11,24,28,0,20/21
Jamaal Lascelles,eng ENG,DF,Newcastle Utd,26,1993,18.1,14,7,5,9,0,3,6,50,3,27,17,10,12,26,86,0,20/21
Maxime Le Marchand,fr FRA,DF,Fulham,30,1989,1.4,2,2,2,0,0,2,2,100,0,0,0,0,0,2,3,0,20/21
Mario Lemina,ga GAB,MF,Fulham,26,1993,18.9,62,35,25,30,7,23,44,52.3,21,26,5,21,30,92,21,0,20/21
Bernd Leno,de GER,GK,Arsenal,28,1992,34.8,1,0,1,0,0,1,1,100,0,1,0,1,0,1,11,2,20/21
Khanya Leshabela,za RSA,MF,Leicester City,20,1999,0.1,0,0,0,0,0,0,0,,0,0,0,0,0,0,0,0,20/21
Jamal Lewis,nir NIR,DF,Newcastle Utd,22,1998,20.4,37,20,23,13,1,16,38,42.1,22,21,7,14,11,48,44,1,20/21
Victor Lindelöf,se SWE,DF,Manchester Utd,26,1994,28.7,22,10,12,10,0,12,24,50,12,22,14,8,30,52,95,1,20/21
Jesse Lingard,eng ENG,MFFW,West Ham,27,1992,15.8,12,6,4,8,0,5,14,35.7,9,7,1,6,4,16,0,0,20/21
Jake Livermore,eng ENG,MF,West Brom,30,1989,13.8,33,18,14,16,3,14,31,45.2,17,21,6,15,16,49,26,0,20/21
Diego Llorente,es ESP,DF,Leeds United,26,1993,13.4,34,21,21,13,0,19,32,59.4,13,18,13,5,20,54,40,2,20/21
Hugo Lloris,fr FRA,GK,Tottenham,33,1986,38,0,0,0,0,0,0,1,0,1,0,0,0,0,0,10,1,20/21
Giovani Lo Celso,ar ARG,MF,Tottenham,24,1996,10.5,28,22,12,11,5,10,29,34.5,19,12,1,11,7,35,5,0,20/21
Ruben Loftus-Cheek,eng ENG,FW,Chelsea,24,1996,0.7,0,0,0,0,0,0,0,,0,0,0,0,0,0,0,0,20/21
Ruben Loftus-Cheek,eng ENG,MFFW,Fulham,24,1996,21.2,25,14,7,15,3,7,23,30.4,16,20,2,18,7,32,18,0,20/21
Kevin Long,ie IRL,DF,Burnley,29,1990,7.1,11,6,9,2,0,7,9,77.8,2,11,7,4,6,17,24,0,20/21
Shane Long,ie IRL,FW,Southampton,33,1987,2.3,2,1,0,0,2,2,3,66.7,1,0,0,0,3,5,1,0,20/21
Matthew Longstaff,eng ENG,MF,Newcastle Utd,20,2000,4.2,3,2,2,1,0,2,8,25,6,7,0,7,7,10,2,0,20/21
Sean Longstaff,eng ENG,MF,Newcastle Utd,22,1997,15.7,31,14,13,15,3,18,42,42.9,24,26,5,21,19,50,14,2,20/21
Ademola Lookman,ng NGA,FWMF,Fulham,22,1997,30.5,35,11,18,9,8,13,44,29.5,31,31,1,30,20,55,9,0,20/21
Max Lowe,eng ENG,DF,Sheffield Utd,23,1997,6.1,26,11,18,6,2,9,21,42.9,12,12,4,8,5,31,11,0,20/21
Matthew Lowton,eng ENG,DF,Burnley,31,1989,34,54,32,31,22,1,32,73,43.8,41,36,13,23,56,110,91,1,20/21
David Luiz,br BRA,DF,Arsenal,33,1987,15.5,12,9,5,7,0,4,4,100,0,16,9,7,16,28,50,2,20/21
Douglas Luiz,br BRA,MF,Aston Villa,22,1998,30.9,49,18,22,26,1,20,58,34.5,38,52,17,35,43,92,44,2,20/21
John Lundstram,eng ENG,MF,Sheffield Utd,26,1994,22.6,25,16,12,11,2,13,47,27.7,34,26,8,18,14,39,29,1,20/21
Alexis Mac Allister,ar ARG,MFFW,Brighton,21,1998,12.4,26,12,6,16,4,11,38,28.9,27,25,4,21,9,35,4,0,20/21
James Maddison,eng ENG,MF,Leicester City,23,1996,23.3,32,16,5,16,11,14,41,34.1,27,14,1,13,9,41,5,0,20/21
Harry Maguire,eng ENG,DF,Manchester Utd,27,1993,33.9,29,17,19,10,0,18,29,62.1,11,28,23,5,60,89,122,4,20/21
Riyad Mahrez,dz ALG,FW,Manchester City,29,1991,21.7,20,5,2,10,8,6,30,20,24,19,0,19,8,28,4,0,20/21
Ainsley Maitland-Niles,eng ENG,MFDF,Arsenal,22,1997,5.4,11,7,6,5,0,8,12,66.7,4,12,2,10,14,25,7,1,20/21
Ainsley Maitland-Niles,eng ENG,MF,West Brom,22,1997,13.7,22,10,7,8,7,9,28,32.1,19,12,1,11,17,39,24,0,20/21
Josh Maja,ng NGA,FW,Fulham,21,1998,9,7,4,0,3,4,4,10,40,6,3,1,2,4,11,1,0,20/21
Sadio Mané,sn SEN,FW,Liverpool,28,1992,31.2,48,30,6,22,20,12,33,36.4,21,30,0,30,15,63,11,0,20/21
Javier Manquillo,es ESP,DF,Newcastle Utd,26,1994,9.2,24,14,8,14,2,11,17,64.7,6,8,1,7,9,33,15,1,20/21
Fernando Marçal,br BRA,DFMF,Wolves,31,1989,6.9,13,5,6,7,0,6,11,54.5,5,11,2,9,12,25,25,0,20/21
Solly March,eng ENG,DFMF,Brighton,26,1994,18.6,49,23,24,15,10,18,34,52.9,16,30,5,25,22,71,30,0,20/21
Pablo Marí,es ESP,DF,Arsenal,26,1993,10,15,9,12,3,0,5,10,50,5,8,7,1,9,24,30,2,20/21
Anthony Martial,fr FRA,FW,Manchester Utd,24,1995,16.4,2,1,1,1,0,0,10,0,10,17,3,14,1,3,8,0,20/21
Martinelli,br BRA,FW,Arsenal,19,2001,6.5,7,1,2,3,2,4,10,40,6,6,0,6,8,15,4,0,20/21
Emiliano Martínez,ar ARG,GK,Aston Villa,27,1992,38,3,3,3,0,0,3,4,75,1,0,0,0,2,5,10,2,20/21
Arthur Masuaku,cd COD,DFMF,West Ham,26,1993,11.2,20,12,14,6,0,11,34,32.4,23,12,0,12,8,28,28,2,20/21
Juan Mata,es ESP,FWMF,Manchester Utd,32,1988,5.7,1,0,1,0,0,0,7,0,7,3,0,3,3,4,3,0,20/21
Jean-Philippe Mateta,fr FRA,FW,Crystal Palace,23,1997,2.5,1,1,0,1,0,1,3,33.3,2,1,0,1,0,1,2,0,20/21
Nemanja Matić,rs SRB,MF,Manchester Utd,31,1988,12.3,25,11,13,12,0,13,31,41.9,18,19,5,14,22,47,10,3,20/21
Joël Matip,cm CMR,DF,Liverpool,28,1991,7.7,14,9,7,7,0,7,8,87.5,1,6,0,6,7,21,22,0,20/21
Neal Maupay,fr FRA,FWMF,Brighton,23,1996,27.9,20,8,9,7,4,4,24,16.7,20,20,0,20,13,33,6,0,20/21
James McArthur,sct SCO,MF,Crystal Palace,32,1987,16.3,57,32,25,27,5,15,39,38.5,24,28,3,25,23,80,31,0,20/21
Oliver McBurnie,sct SCO,FW,Sheffield Utd,24,1996,14.7,15,7,7,7,1,5,17,29.4,12,10,3,7,6,21,30,0,20/21
Alex McCarthy,eng ENG,GK,Southampton,30,1989,30,1,0,1,0,0,1,4,25,3,0,0,0,0,1,11,1,20/21
James McCarthy,ie IRL,MF,Crystal Palace,29,1990,9.1,16,12,9,7,0,8,21,38.1,13,15,7,8,8,24,12,0,20/21
John McGinn,sct SCO,MF,Aston Villa,25,1994,37,61,37,23,31,7,27,84,32.1,57,38,6,32,43,104,23,2,20/21
David McGoldrick,ie IRL,FWMF,Sheffield Utd,32,1987,26.6,33,21,8,15,10,13,31,41.9,18,19,3,16,2,35,25,0,20/21
Dwight McNeil,eng ENG,MF,Burnley,20,1999,34.1,47,24,24,18,5,18,56,32.1,38,44,6,38,32,79,32,1,20/21
Scott McTominay,sct SCO,MF,Manchester Utd,23,1996,23.7,51,24,23,25,3,23,36,63.9,13,35,10,25,29,80,46,0,20/21
Ben Mee,eng ENG,DF,Burnley,30,1989,29.9,32,15,16,14,2,14,29,48.3,15,54,45,9,43,75,148,2,20/21
Hannibal Mejbri,tn TUN,MF,Manchester Utd,17,2003,0.1,0,0,0,0,0,0,0,,0,0,0,0,0,0,0,0,20/21
Benjamin Mendy,fr FRA,DF,Manchester City,26,1994,10.6,13,9,1,8,4,5,21,23.8,16,12,5,7,5,18,14,1,20/21
Edouard Mendy,sn SEN,GK,Chelsea,28,1992,30.5,0,0,0,0,0,0,1,0,1,0,0,0,1,1,9,3,20/21
Nampalys Mendy,sn SEN,MF,Leicester City,28,1992,16.2,26,17,18,6,2,7,20,35,13,12,1,11,14,40,8,0,20/21
Illan Meslier,fr FRA,GK,Leeds United,20,2000,35,0,0,0,0,0,0,1,0,1,0,0,0,0,0,17,8,20/21
Luka Milivojević,rs SRB,MF,Crystal Palace,29,1991,26.2,65,34,25,31,9,42,77,54.5,35,29,6,23,35,100,47,2,20/21
James Milner,eng ENG,MFDF,Liverpool,34,1986,11.9,26,19,9,14,3,11,33,33.3,22,30,3,27,14,40,16,1,20/21
Yerry Mina,co COL,DF,Everton,25,1994,21.5,21,14,17,4,0,8,12,66.7,4,30,23,7,24,45,110,1,20/21
Takumi Minamino,jp JPN,MF,Southampton,25,1995,7.9,7,3,2,5,0,2,19,10.5,17,13,1,12,4,11,9,0,20/21
Takumi Minamino,jp JPN,MFFW,Liverpool,25,1995,3.3,4,3,1,2,1,0,12,0,12,1,0,1,2,6,3,0,20/21
Tyrone Mings,eng ENG,DF,Aston Villa,27,1993,35.5,32,16,23,7,2,16,24,66.7,8,59,40,19,41,73,172,3,20/21
Tyrick Mitchell,eng ENG,DF,Crystal Palace,20,1999,19,64,35,48,9,7,23,40,57.5,17,29,10,19,21,85,62,1,20/21
Aleksandar Mitrović,rs SRB,FW,Fulham,25,1994,15.6,7,4,0,3,4,2,8,25,6,12,3,9,3,10,8,0,20/21
Jakub Moder,pl POL,DFMF,Brighton,21,1999,7.2,15,7,5,7,3,7,20,35,13,12,1,11,3,18,9,0,20/21
Jayson Molumby,ie IRL,MF,Brighton,20,1999,0,0,0,0,0,0,0,0,,0,0,0,0,0,0,0,0,20/21
Wesley Moraes,br BRA,FW,Aston Villa,23,1996,0.2,0,0,0,0,0,0,1,0,1,0,0,0,0,0,0,0,20/21
Wes Morgan,jm JAM,DF,Leicester City,36,1984,0.2,0,0,0,0,0,0,0,,0,0,0,0,0,0,1,0,20/21
Mason Mount,eng ENG,MF,Chelsea,21,1999,32.1,75,35,22,38,15,25,69,36.2,44,40,2,38,31,106,14,0,20/21
Lucas Moura,br BRA,FWMF,Tottenham,27,1992,15.7,32,16,12,16,4,8,29,27.6,21,12,0,12,18,50,10,0,20/21
Lys Mousset,fr FRA,FWMF,Sheffield Utd,24,1996,3.3,1,0,0,0,1,0,2,0,2,1,0,1,0,1,1,1,20/21
João Moutinho,pt POR,MF,Wolves,33,1986,28.1,75,40,34,35,6,35,91,38.5,56,18,3,15,47,122,28,0,20/21
Joel Mumbongo,se SWE,FW,Burnley,21,1999,0.4,0,0,0,0,0,0,0,,0,1,0,1,0,0,0,0,20/21
Jacob Murphy,eng ENG,DFMF,Newcastle Utd,25,1995,18.1,39,24,25,12,2,24,49,49,25,27,3,24,14,53,29,0,20/21
Shkodran Mustafi,de GER,DF,Arsenal,28,1992,0.5,1,1,1,0,0,1,1,100,0,1,0,1,0,1,3,0,20/21
Marvelous Nakamba,zw ZIM,MF,Aston Villa,26,1994,8.3,22,14,10,11,1,7,12,58.3,5,16,5,11,17,39,9,1,20/21
Iliman Ndiaye,sn SEN,MF,Sheffield Utd,20,2000,0.1,1,1,0,1,0,1,1,100,0,0,0,0,0,1,0,0,20/21
Wilfred Ndidi,ng NGA,MFDF,Leicester City,23,1996,24.2,96,63,45,44,7,26,66,39.4,40,38,11,27,61,157,55,0,20/21
Tanguy Ndombele,fr FRA,MF,Tottenham,23,1996,23.2,41,20,11,21,9,18,44,40.9,26,28,4,24,19,60,15,0,20/21
Reiss Nelson,eng ENG,FWMF,Arsenal,20,1999,0.8,1,0,0,0,1,0,0,,0,0,0,0,1,2,1,0,20/21
Pedro Neto,pt POR,FWMF,Wolves,20,2000,28.3,16,9,4,6,6,6,28,21.4,22,18,2,16,31,47,8,0,20/21
Rúben Neves,pt POR,MF,Wolves,23,1997,29.7,86,46,42,38,6,36,88,40.9,52,55,11,44,65,151,46,2,20/21
Eddie Nketiah,eng ENG,FW,Arsenal,21,1999,4.7,3,1,0,2,1,0,2,0,2,6,0,6,0,3,5,0,20/21
Niels Nkounkou,fr FRA,DFFW,Everton,19,2000,0.9,4,3,1,2,1,3,8,37.5,5,4,0,4,0,4,4,0,20/21
Dan Nlundulu,eng ENG,FWMF,Southampton,21,1999,1.2,0,0,0,0,0,0,1,0,1,2,0,2,0,0,2,0,20/21
Mark Noble,eng ENG,MF,West Ham,33,1987,7.9,8,4,2,5,1,4,14,28.6,10,7,3,4,13,21,3,0,20/21
Will Norris,eng ENG,GK,Burnley,26,1993,2,0,0,0,0,0,0,0,,0,0,0,0,0,0,0,0,20/21
Oliver Norwood,nir NIR,MF,Sheffield Utd,29,1991,24.7,49,22,16,28,5,21,72,29.2,51,29,12,17,36,85,51,1,20/21
Jack O'Connell,eng ENG,DF,Sheffield Utd,26,1994,2,3,1,1,1,1,0,1,0,1,4,3,1,2,5,7,0,20/21
Dara O'Shea,ie IRL,DF,West Brom,21,1999,23.4,45,25,30,13,2,21,45,46.7,24,32,17,15,45,90,108,0,20/21
Michael Obafemi,ie IRL,FW,Southampton,20,2000,0.7,1,0,0,1,0,0,1,0,1,1,0,1,0,1,0,0,20/21
Denis Odoi,gh GHA,DF,Fulham,32,1988,3,3,3,2,1,0,1,4,25,3,3,1,2,5,8,5,0,20/21
Angelo Ogbonna,it ITA,DF,West Ham,32,1988,27.7,26,13,20,5,1,9,17,52.9,8,25,11,14,30,56,119,0,20/21
Robin Olsen,se SWE,GK,Everton,30,1990,7,0,0,0,0,0,0,0,,0,0,0,0,0,0,4,1,20/21
Josh Onomah,eng ENG,MF,Fulham,23,1997,4.2,11,8,1,6,4,0,5,0,5,4,2,2,2,13,1,0,20/21
Divock Origi,be BEL,FW,Liverpool,25,1995,2.1,3,2,0,2,1,1,3,33.3,2,5,1,4,1,4,2,0,20/21
Ben Osborn,eng ENG,MFDF,Sheffield Utd,25,1994,17.8,33,18,15,10,8,13,40,32.5,27,20,3,17,12,45,17,0,20/21
Owen Otasowie,us USA,MFFW,Wolves,19,2001,2.1,5,5,3,2,0,1,2,50,1,1,1,0,3,8,4,0,20/21
Alex Oxlade-Chamberlain,eng ENG,MFFW,Liverpool,26,1993,2.8,4,0,0,3,1,0,2,0,2,1,0,1,2,6,0,0,20/21
Emerson Palmieri,it ITA,DF,Chelsea,25,1994,1,3,3,2,0,1,1,3,33.3,2,0,0,0,1,4,6,0,20/21
Thomas Partey,gh GHA,MF,Arsenal,27,1993,17,44,21,16,24,4,24,56,42.9,32,17,5,12,23,67,18,0,20/21
Rui Patrício,pt POR,GK,Wolves,32,1988,37,0,0,0,0,0,0,1,0,1,0,0,0,1,1,3,3,20/21
Bailey Peacock-Farrell,nir NIR,GK,Burnley,23,1996,4,0,0,0,0,0,0,0,,0,0,0,0,0,0,0,0,20/21
Lee Peltier,eng ENG,DF,West Brom,33,1986,2.5,9,4,8,1,0,4,4,100,0,1,1,0,1,10,11,0,20/21
Nicolas Pépé,ci CIV,FW,Arsenal,25,1995,18,20,15,8,6,6,8,23,34.8,15,16,1,15,12,32,19,0,20/21
Matheus Pereira,pt POR,MFFW,West Brom,24,1996,28.6,26,15,14,10,2,12,54,22.2,42,18,0,18,29,55,16,0,20/21
Ricardo Pereira,pt POR,DFFW,Leicester City,26,1993,10.7,31,22,16,8,7,14,35,40,21,24,1,23,15,46,23,0,20/21
Ayoze Pérez,es ESP,MFFW,Leicester City,27,1993,14.8,32,15,6,20,6,13,48,27.1,35,28,0,28,10,42,7,0,20/21
Kalvin Phillips,eng ENG,MF,Leeds United,24,1995,27,74,38,38,29,7,26,62,41.9,36,49,14,35,45,119,53,3,20/21
Matt Phillips,sct SCO,MF,West Brom,29,1991,20.3,15,8,4,11,0,7,23,30.4,16,32,4,28,10,25,32,1,20/21
Nathaniel Phillips,eng ENG,DF,Liverpool,23,1997,16.2,22,14,15,7,0,11,24,45.8,13,17,14,3,20,42,81,0,20/21
Jaden Philogene Bidace,eng ENG,FW,Aston Villa,18,2002,0,0,0,0,0,0,0,0,,0,0,0,0,0,0,0,0,20/21
Jordan Pickford,eng ENG,GK,Everton,26,1994,30.5,0,0,0,0,0,0,2,0,2,2,0,2,3,3,16,4,20/21
Erik Pieters,nl NED,DFMF,Burnley,31,1988,14.1,30,21,18,9,3,19,39,48.7,20,30,9,21,12,42,34,0,20/21
Daniel Podence,pt POR,MFFW,Wolves,24,1995,18.5,12,6,5,5,2,2,19,10.5,17,5,1,4,13,25,2,0,20/21
Paul Pogba,fr FRA,MFFW,Manchester Utd,27,1993,21.1,36,26,15,16,5,11,33,33.3,22,24,2,22,26,62,37,0,20/21
Nick Pope,eng ENG,GK,Burnley,28,1992,32,1,1,1,0,0,0,1,0,1,0,0,0,2,3,29,2,20/21
Dennis Praet,be BEL,MF,Leicester City,26,1994,8,14,7,4,7,3,6,15,40,9,12,2,10,7,21,3,0,20/21
Davy Pröpper,nl NED,MF,Brighton,28,1991,2.4,6,5,0,6,0,2,5,40,3,3,0,3,1,7,0,0,20/21
Christian Pulisic,us USA,FWMF,Chelsea,21,1998,19.3,19,11,8,10,1,8,21,38.1,13,25,2,23,12,31,9,0,20/21
Aaron Ramsdale,eng ENG,GK,Sheffield Utd,22,1998,38,1,1,1,0,0,1,1,100,0,0,0,0,2,3,22,6,20/21
Jacob Ramsey,eng ENG,MF,Aston Villa,19,2001,7,10,5,3,4,3,2,12,16.7,10,13,6,7,4,14,5,0,20/21
Kayne Ramsey,eng ENG,DF,Southampton,19,2000,1,5,2,4,1,0,3,3,100,0,0,0,0,0,5,3,0,20/21
Darren Randolph,ie IRL,GK,West Ham,33,1987,3,0,0,0,0,0,0,0,,0,0,0,0,0,0,1,0,20/21
Raphinha,br BRA,MFFW,Leeds United,23,1996,26.2,34,17,13,16,5,12,58,20.7,46,31,1,30,29,63,27,0,20/21
Marcus Rashford,eng ENG,FW,Manchester Utd,22,1997,32.4,18,9,2,8,8,7,27,25.9,20,22,2,20,8,26,10,0,20/21
Tim Ream,us USA,DF,Fulham,32,1987,7,12,5,9,3,0,8,11,72.7,3,8,5,3,6,18,26,1,20/21
Nathan Redmond,eng ENG,MFFW,Southampton,26,1994,19.3,30,17,14,12,4,8,24,33.3,16,24,2,22,11,41,9,0,20/21
Harrison Reed,eng ENG,MF,Fulham,25,1995,25,63,38,28,28,7,29,73,39.7,44,34,11,23,50,113,31,1,20/21
Sergio Reguilón,es ESP,DF,Tottenham,23,1996,24.9,47,25,30,13,4,23,48,47.9,25,39,7,32,32,79,50,1,20/21
Bobby Reid,jm JAM,MFFW,Fulham,27,1993,26.4,31,15,17,10,4,18,39,46.2,21,19,5,14,21,52,39,0,20/21
Declan Rice,eng ENG,MF,West Ham,21,1999,32,59,35,33,25,1,21,51,41.2,30,39,11,28,59,118,41,0,20/21
Lewis Richardson,eng ENG,FWMF,Burnley,17,2003,0,0,0,0,0,0,0,0,,0,0,0,0,0,0,0,0,20/21
Richarlison,br BRA,FW,Everton,23,1997,31.8,50,32,21,22,7,16,51,31.4,35,28,3,25,14,64,36,1,20/21
Jaïro Riedewald,nl NED,MF,Crystal Palace,23,1996,20.2,34,15,13,17,4,16,36,44.4,20,39,7,32,29,63,25,0,20/21
Matt Ritchie,sct SCO,DFMF,Newcastle Utd,30,1989,15,10,3,5,3,2,3,17,17.6,14,17,2,15,12,22,47,0,20/21
Tyler Roberts,wls WAL,MFFW,Leeds United,21,1999,14.9,15,13,1,11,3,5,22,22.7,17,17,2,15,9,24,12,0,20/21
Andrew Robertson,sct SCO,DF,Liverpool,26,1994,37.6,46,34,23,18,5,28,57,49.1,29,39,9,30,21,67,79,1,20/21
Antonee Robinson,us USA,DF,Fulham,22,1997,24,45,28,24,16,5,27,44,61.4,17,21,4,17,37,82,68,0,20/21
Callum Robinson,ie IRL,FWMF,West Brom,25,1995,17.3,7,5,5,1,1,3,19,15.8,16,9,0,9,7,14,8,0,20/21
Jack Robinson,eng ENG,DF,Sheffield Utd,26,1993,9.7,14,6,8,5,1,6,11,54.5,5,10,4,6,9,23,42,0,20/21
Hal Robson-Kanu,wls WAL,FW,West Brom,31,1989,6.2,2,1,1,0,1,0,1,0,1,2,0,2,2,4,7,0,20/21
Marek Rodák,sk SVK,GK,Fulham,23,1996,2,0,0,0,0,0,0,0,,0,0,0,0,0,0,0,0,20/21
Joe Rodon,wls WAL,DF,Tottenham,22,1997,8.1,14,9,11,2,1,3,4,75,1,10,8,2,21,35,36,2,20/21
Rodri,es ESP,MF,Manchester City,24,1996,30.5,72,40,24,40,8,33,66,50,33,23,9,14,36,108,54,3,20/21
Rodrigo,es ESP,MFFW,Leeds United,29,1991,14.3,14,7,8,3,3,4,22,18.2,18,7,0,7,5,19,16,0,20/21
James Rodríguez,co COL,FWMF,Everton,29,1991,19.6,28,17,8,15,5,11,46,23.9,35,17,0,17,15,43,3,0,20/21
Jay Rodriguez,eng ENG,FW,Burnley,31,1989,14.1,25,16,5,15,5,13,28,46.4,15,25,4,21,2,27,7,0,20/21
Oriol Romeu,es ESP,MF,Southampton,28,1991,19.6,69,35,25,39,5,26,68,38.2,42,28,7,21,30,99,18,0,20/21
John Ruddy,eng ENG,GK,Wolves,33,1986,1,0,0,0,0,0,0,0,,0,0,0,0,0,0,0,0,20/21
Antonio Rüdiger,de GER,DF,Chelsea,27,1993,19,31,23,16,14,1,12,15,80,3,17,10,7,18,49,51,0,20/21
Mathew Ryan,au AUS,GK,Arsenal,28,1992,3,0,0,0,0,0,0,0,,0,0,0,0,0,0,1,0,20/21
Mathew Ryan,au AUS,GK,Brighton,28,1992,11,1,0,1,0,0,0,0,,0,0,0,0,0,1,4,0,20/21
Allan Saint-Maximin,fr FRA,FWMF,Newcastle Utd,23,1997,17.3,16,9,6,9,1,4,9,44.4,5,10,0,10,4,20,2,0,20/21
Romain Saïss,ma MAR,DF,Wolves,30,1990,26.7,35,24,23,12,0,19,33,57.6,14,28,13,15,52,87,115,1,20/21
Bukayo Saka,eng ENG,FWMF,Arsenal,18,2001,28.4,25,16,10,13,2,11,40,27.5,29,21,2,19,25,50,24,0,20/21
Mamadou Sakho,fr FRA,DF,Crystal Palace,30,1990,3.1,3,2,1,2,0,3,3,100,0,3,2,1,3,6,11,0,20/21
Mohamed Salah,eg EGY,FW,Liverpool,28,1992,34.2,18,9,4,4,10,7,16,43.8,9,10,0,10,1,19,10,1,20/21
Mohammed Salisu,gh GHA,DF,Southampton,21,1999,9.4,38,21,20,16,2,25,34,73.5,9,22,5,17,17,55,30,0,20/21
Davinson Sánchez,co COL,DF,Tottenham,24,1996,16.5,40,20,31,9,0,21,32,65.6,11,18,13,5,14,54,85,2,20/21
Robert Sánchez,es ESP,GK,Brighton,22,1997,27,1,0,1,0,0,1,1,100,0,1,0,1,1,2,11,2,20/21
Morgan Sanson,fr FRA,MF,Aston Villa,25,1994,3.3,7,4,4,2,1,1,4,25,3,5,0,5,4,11,1,0,20/21
Romaine Sawyers,kn SKN,MF,West Brom,28,1991,16.5,30,18,16,12,2,14,43,32.6,29,20,4,16,18,48,12,3,20/21
Dane Scarlett,eng ENG,FW,Tottenham,16,2004,0,0,0,0,0,0,0,0,,0,0,0,0,0,0,0,0,20/21
Fabian Schär,ch SUI,DF,Newcastle Utd,28,1991,13.8,13,4,8,5,0,7,19,36.8,12,19,12,7,27,40,52,1,20/21
Jeffrey Schlupp,gh GHA,MF,Crystal Palace,27,1992,15.9,29,16,14,12,3,6,23,26.1,17,24,8,16,22,51,16,0,20/21
Kasper Schmeichel,dk DEN,GK,Leicester City,33,1986,38,0,0,0,0,0,0,0,,0,0,0,0,0,0,10,0,20/21
Nélson Semedo,pt POR,DFMF,Wolves,26,1993,33.1,85,48,53,23,9,42,72,58.3,30,30,10,20,41,126,78,2,20/21
Femi Seriki,eng ENG,MF,Sheffield Utd,18,2002,0,0,0,0,0,0,0,0,,0,0,0,0,0,0,0,0,20/21
Jamie Shackleton,eng ENG,MFDF,Leeds United,20,1999,5.1,10,6,6,4,0,4,11,36.4,7,3,1,2,9,19,3,0,20/21
Xherdan Shaqiri,ch SUI,MFFW,Liverpool,28,1991,6.2,7,4,3,1,3,2,7,28.6,5,4,0,4,2,9,0,0,20/21
Billy Sharp,eng ENG,FW,Sheffield Utd,34,1986,8.2,5,1,0,3,2,2,9,22.2,7,2,0,2,0,5,2,0,20/21
Luke Shaw,eng ENG,DF,Manchester Utd,25,1995,29.5,44,28,21,16,7,21,36,58.3,15,34,9,25,20,64,44,2,20/21
Jonjo Shelvey,eng ENG,MF,Newcastle Utd,28,1992,29.1,39,14,18,19,2,10,37,27,27,26,14,12,36,75,42,0,20/21
Shola Shoretire,eng ENG,FW,Manchester Utd,16,2004,0.1,0,0,0,0,0,0,0,,0,0,0,0,0,0,0,0,20/21
Gylfi Sigurðsson,is ISL,MFFW,Everton,30,1989,25,30,20,9,14,7,13,44,29.5,31,31,2,29,34,64,21,1,20/21
Bernardo Silva,pt POR,MFFW,Manchester City,25,1994,22.9,26,14,7,12,7,11,52,21.2,41,17,1,16,17,43,8,0,20/21
Fábio Silva,pt POR,FW,Wolves,18,2002,15.2,6,4,1,4,1,4,12,33.3,8,12,1,11,4,10,5,1,20/21
Thiago Silva,br BRA,DF,Chelsea,35,1984,21.5,20,12,11,8,1,14,21,66.7,7,21,13,8,33,53,86,1,20/21
Moussa Sissoko,fr FRA,MF,Tottenham,30,1989,17.6,22,16,19,3,0,8,20,40,12,11,4,7,23,45,25,0,20/21
Islam Slimani,dz ALG,FW,Leicester City,32,1988,0.2,0,0,0,0,0,0,0,,0,0,0,0,0,0,0,0,20/21
William Smallbone,ie IRL,MF,Southampton,20,2000,1.9,6,3,2,4,0,1,3,33.3,2,5,0,5,2,8,1,0,20/21
Emile Smith Rowe,eng ENG,MFFW,Arsenal,20,2000,16,14,7,5,5,4,6,17,35.3,11,15,1,14,10,24,12,0,20/21
Robert Snodgrass,sct SCO,MFFW,West Brom,32,1987,5.8,17,12,12,4,1,10,16,62.5,6,11,2,9,1,18,12,0,20/21
Robert Snodgrass,sct SCO,FWMF,West Ham,32,1987,0.1,0,0,0,0,0,0,0,,0,0,0,0,0,0,0,0,20/21
Cédric Soares,pt POR,DF,Arsenal,28,1991,8.3,12,8,6,4,2,6,21,28.6,15,6,1,5,8,20,16,1,20/21
Tomáš Souček,cz CZE,MF,West Ham,25,1995,38,78,41,37,36,5,28,77,36.4,49,43,18,25,62,140,107,0,20/21
Çağlar Söyüncü,tr TUR,DF,Leicester City,24,1996,20.2,27,17,13,14,0,17,30,56.7,13,12,9,3,28,55,80,1,20/21
Zack Steffen,us USA,GK,Manchester City,25,1995,1,0,0,0,0,0,0,0,,0,0,0,0,0,0,0,0,20/21
Dale Stephens,eng ENG,MF,Burnley,31,1989,2.9,11,6,2,7,2,3,6,50,3,3,0,3,8,19,2,0,20/21
Jack Stephens,eng ENG,DF,Southampton,26,1994,17.1,34,19,19,15,0,17,38,44.7,21,25,14,11,28,62,64,2,20/21
Raheem Sterling,eng ENG,FW,Manchester City,25,1994,28.2,21,10,5,12,4,5,12,41.7,7,15,0,15,15,36,4,0,20/21
Enda Stevens,ie IRL,DF,Sheffield Utd,30,1990,30,59,26,32,19,8,33,58,56.9,25,41,12,29,22,81,81,1,20/21
John Stones,eng ENG,DF,Manchester City,26,1994,21.5,21,10,13,5,3,9,14,64.3,5,23,15,8,18,39,56,1,20/21
Pascal Struijk,nl NED,DFMF,Leeds United,20,1999,23.1,49,30,28,19,2,17,28,60.7,11,35,21,14,47,96,92,0,20/21
Japhet Tanganga,eng ENG,DF,Tottenham,21,1999,5.4,5,4,3,2,0,1,3,33.3,2,6,5,1,3,8,15,0,20/21
Matt Targett,eng ENG,DF,Aston Villa,24,1995,37.8,83,39,52,20,11,56,88,63.6,32,40,14,26,55,138,102,1,20/21
James Tarkowski,eng ENG,DF,Burnley,27,1992,36,66,39,52,11,3,25,49,51,24,54,42,12,44,110,163,1,20/21
Percy Tau,za RSA,FW,Brighton,26,1994,1.1,1,1,1,0,0,0,2,0,2,1,0,1,0,1,1,0,20/21
Sidnei Tavares,pt POR,MF,Leicester City,18,2001,0.9,1,1,0,1,0,0,0,,0,1,1,0,0,1,0,0,20/21
Charlie Taylor,eng ENG,DF,Burnley,26,1993,27,48,28,30,15,3,25,46,54.3,21,36,19,17,29,77,87,2,20/21
Neil Taylor,wls WAL,DF,Aston Villa,31,1989,0.2,1,1,1,0,0,0,0,,0,1,0,1,0,1,0,0,20/21
Allan Tchaptchet,fr FRA,DF,Southampton,18,2001,0.1,0,0,0,0,0,0,0,,0,0,0,0,0,0,0,0,20/21
Nathan Tella,eng ENG,FWMF,Southampton,21,1999,8.3,8,5,1,4,3,6,15,40,9,13,0,13,3,11,2,0,20/21
Alex Telles,br BRA,DF,Manchester Utd,27,1992,7.7,14,7,10,3,1,8,17,47.1,9,7,2,5,16,30,20,0,20/21
Kenny Tete,nl NED,DFMF,Fulham,24,1995,16.5,48,30,27,16,5,10,18,55.6,8,14,5,9,27,75,49,0,20/21
William Thomas Fish,eng ENG,FW,Manchester Utd,17,2003,0,0,0,0,0,0,0,0,,0,0,0,0,0,0,0,0,20/21
Luke Thomas,eng ENG,DF,Leicester City,19,2001,10.8,23,14,11,5,7,14,21,66.7,7,15,2,13,17,40,21,0,20/21
Youri Tielemans,be BEL,MF,Leicester City,23,1997,37.3,86,45,32,38,16,45,108,41.7,63,35,8,27,46,132,20,1,20/21
Kieran Tierney,sct SCO,DF,Arsenal,23,1997,25.5,27,15,5,14,8,11,31,35.5,20,31,10,21,16,43,63,0,20/21
James Tomkins,eng ENG,DF,Crystal Palace,31,1989,6.1,4,2,4,0,0,3,4,75,1,4,3,1,4,8,45,0,20/21
Fikayo Tomori,eng ENG,DF,Chelsea,22,1997,0.5,2,1,2,0,0,0,0,,0,1,1,0,2,4,8,0,20/21
Ferrán Torres,es ESP,FWMF,Manchester City,20,2000,14.5,12,5,4,6,2,5,16,31.3,11,16,0,16,3,15,8,0,20/21
Cenk Tosun,tr TUR,FW,Everton,29,1991,0.5,0,0,0,0,0,0,1,0,1,0,0,0,0,0,0,0,20/21
Andros Townsend,eng ENG,MFFW,Crystal Palace,29,1991,25.1,78,41,45,20,13,30,79,38,49,48,2,46,41,119,19,0,20/21
Conor Townsend,eng ENG,DF,West Brom,27,1993,24.8,44,28,32,9,3,30,49,61.2,19,38,15,23,36,80,55,2,20/21
Adama Traoré,es ESP,FWMF,Wolves,24,1996,29.4,28,16,11,13,4,13,21,61.9,8,23,1,22,7,35,12,1,20/21
Bertrand Traoré,bf BFA,FW,Aston Villa,24,1995,25.7,26,10,8,10,8,10,34,29.4,24,23,1,22,15,41,14,1,20/21
Trézéguet,eg EGY,FW,Aston Villa,25,1994,13,33,18,14,15,4,13,45,28.9,32,13,1,12,19,52,17,0,20/21
Leandro Trossard,be BEL,MFFW,Brighton,25,1994,29,33,14,11,16,6,10,36,27.8,26,34,2,32,26,59,7,1,20/21
Kostas Tsimikas,gr GRE,DFFW,Liverpool,24,1996,0.1,0,0,0,0,0,0,0,,0,0,0,0,0,0,0,0,20/21
Axel Tuanzebe,eng ENG,DF,Manchester Utd,22,1997,4.5,13,7,5,7,1,8,9,88.9,1,7,5,2,3,16,18,0,20/21
Cengiz Ünder,tr TUR,FWMF,Leicester City,23,1997,3.1,4,1,0,3,1,3,5,60,2,3,0,3,2,6,0,0,20/21
Yan Valery,tn TUN,DFMF,Southampton,21,1999,1.1,5,3,2,3,0,1,5,20,4,2,0,2,2,7,5,0,20/21
Virgil van Dijk,nl NED,DF,Liverpool,29,1991,4.1,3,2,1,2,0,0,0,,0,1,1,0,5,8,8,1,20/21
Jamie Vardy,eng ENG,FW,Leicester City,33,1987,31.6,18,12,1,8,9,2,15,13.3,13,14,5,9,4,22,32,0,20/21
Joël Veltman,nl NED,DF,Brighton,28,1992,25.3,67,33,34,25,8,29,57,50.9,28,24,5,19,33,100,64,0,20/21
Jannik Vestergaard,dk DEN,DF,Southampton,27,1992,28.6,50,31,31,15,4,35,52,67.3,17,29,16,13,42,92,122,0,20/21
Rúben Vinagre,pt POR,MFDF,Wolves,21,1999,1.9,7,5,5,2,0,3,4,75,1,3,0,3,2,9,4,0,20/21
Carlos Vinícius,br BRA,FW,Tottenham,25,1995,3.4,3,1,2,1,0,1,1,100,0,0,0,0,2,5,5,0,20/21
João Virgínia,pt POR,GK,Everton,20,1999,0.5,0,0,0,0,0,0,0,,0,0,0,0,0,0,0,0,20/21
Vitinha,pt POR,MF,Wolves,20,2000,5.8,7,3,2,5,0,3,8,37.5,5,3,0,3,3,10,1,0,20/21
Jake Vokins,eng ENG,DF,Southampton,20,2000,0.7,0,0,0,0,0,0,1,0,1,0,0,0,0,0,0,0,20/21
Matěj Vydra,cz CZE,FW,Burnley,28,1992,15.2,9,5,2,4,3,1,8,12.5,7,8,1,7,6,15,5,0,20/21
Theo Walcott,eng ENG,MFFW,Southampton,31,1989,18,23,11,8,9,6,11,32,34.4,21,16,0,16,14,37,5,0,20/21
Theo Walcott,eng ENG,FW,Everton,31,1989,0.1,0,0,0,0,0,0,0,,0,0,0,0,0,0,0,0,20/21
Kyle Walker,eng ENG,DF,Manchester City,30,1990,21.6,29,19,15,12,2,16,24,66.7,8,19,7,12,14,43,28,0,20/21
Kyle Walker-Peters,eng ENG,DF,Southampton,23,1997,29.4,83,53,56,25,2,34,57,59.6,23,41,10,31,38,121,66,2,20/21
Aaron Wan-Bissaka,eng ENG,DF,Manchester Utd,22,1997,34,88,54,53,29,6,32,45,71.1,13,65,17,48,62,150,84,2,20/21
Joel Ward,eng ENG,DF,Crystal Palace,30,1989,25.1,43,25,29,14,0,24,42,57.1,18,27,8,19,41,84,87,2,20/21
James Ward-Prowse,eng ENG,MF,Southampton,25,1994,38,75,49,30,41,4,29,70,41.4,41,36,4,32,42,117,60,0,20/21
Ollie Watkins,eng ENG,FW,Aston Villa,24,1995,37,29,17,5,16,8,10,33,30.3,23,21,2,19,7,36,24,0,20/21
Caleb Watts,au AUS,MF,Southampton,18,2002,0.4,2,1,2,0,0,1,2,50,1,0,0,0,0,2,0,0,20/21
Adam Webster,eng ENG,DF,Brighton,25,1995,28.8,29,16,15,10,4,12,25,48,13,29,16,13,47,76,92,3,20/21
Danny Welbeck,eng ENG,FW,Brighton,29,1990,17.2,12,6,2,6,4,7,19,36.8,12,17,0,17,7,19,13,0,20/21
Timo Werner,de GER,FWMF,Chelsea,24,1996,28.9,20,9,6,11,3,7,43,16.3,36,23,1,22,8,28,8,0,20/21
Ashley Westwood,eng ENG,MF,Burnley,30,1990,37.9,23,15,6,12,5,10,42,23.8,32,26,9,17,44,67,33,0,20/21
Ben White,eng ENG,DFMF,Brighton,22,1997,35.5,49,26,21,24,4,24,57,42.1,33,46,22,24,62,111,56,0,20/21
Georginio Wijnaldum,nl NED,MF,Liverpool,29,1990,32.7,23,7,6,14,3,7,31,22.6,24,18,3,15,26,49,18,1,20/21
Brandon Williams,eng ENG,DF,Manchester Utd,19,2000,2.1,0,0,0,0,0,0,1,0,1,1,0,1,1,1,7,0,20/21
Neco Williams,wls WAL,DF,Liverpool,19,2001,2.8,6,5,4,2,0,5,9,55.6,4,3,1,2,6,12,6,0,20/21
Rhys Williams,eng ENG,DF,Liverpool,19,2001,7.3,6,4,3,3,0,3,3,100,0,4,3,1,6,12,27,1,20/21
Willian,br BRA,FW,Arsenal,31,1988,15.6,13,7,6,6,1,6,16,37.5,10,13,0,13,8,21,8,0,20/21
Joe Willock,eng ENG,MF,Arsenal,20,1999,2.6,6,3,1,4,1,3,7,42.9,4,6,1,5,3,9,0,0,20/21
Joe Willock,eng ENG,MF,Newcastle Utd,20,1999,10.9,26,13,16,7,3,9,42,21.4,33,21,3,18,17,43,15,1,20/21
Callum Wilson,eng ENG,FW,Newcastle Utd,28,1992,23.2,12,5,1,6,5,2,12,16.7,10,10,3,7,7,19,14,0,20/21
Harry Winks,eng ENG,MF,Tottenham,24,1996,9.6,16,9,11,5,0,5,20,25,15,16,4,12,11,27,12,1,20/21
Chris Wood,nz NZL,FW,Burnley,28,1991,30.5,12,7,2,4,6,5,18,27.8,13,14,3,11,1,13,21,0,20/21
Granit Xhaka,ch SUI,MFDF,Arsenal,27,1992,28,50,26,18,17,15,30,58,51.7,28,23,7,16,24,74,38,3,20/21
Andriy Yarmolenko,ua UKR,FWMF,West Ham,30,1989,4.2,5,4,2,2,1,2,8,25,6,1,0,1,1,6,2,0,20/21
DeAndre Yedlin,us USA,DF,Newcastle Utd,27,1993,4.8,9,4,8,1,0,4,10,40,6,5,1,4,7,16,17,0,20/21
Okay Yokuşlu,tr TUR,MF,West Brom,26,1994,14.6,38,25,21,13,4,17,35,48.6,18,15,3,12,35,73,33,1,20/21
Wilfried Zaha,ci CIV,FW,Crystal Palace,27,1992,29,26,18,8,15,3,11,30,36.7,19,21,0,21,9,35,4,0,20/21
Andre-Frank Zambo Anguissa,cm CMR,MF,Fulham,24,1995,28.7,78,37,27,38,13,27,68,39.7,41,35,6,29,56,134,17,2,20/21
Andi Zeqiri,ch SUI,FWDF,Brighton,21,1999,1.9,3,2,0,2,1,1,2,50,1,1,0,1,0,3,2,0,20/21
Oleksandr Zinchenko,ua UKR,DF,Manchester City,23,1996,16.4,25,15,12,9,4,14,24,58.3,10,17,4,13,23,48,28,0,20/21
Hakim Ziyech,ma MAR,MFFW,Chelsea,27,1993,13,14,10,5,7,2,5,19,26.3,14,9,1,8,10,24,2,0,20/21
Kurt Zouma,fr FRA,DF,Chelsea,25,1994,22.5,16,10,8,6,2,4,8,50,4,13,9,4,28,44,93,0,20/21
Martin Ødegaard,no NOR,MF,Arsenal,21,1998,9.6,9,3,2,6,1,4,14,28.6,10,2,0,2,2,11,5,0,20/21
Patrick van Aanholt,nl NED,DF,Crystal Palace,28,1990,27.9,43,23,31,10,2,23,50,46,27,31,9,22,45,88,52,1,19/20
Max Aarons,eng ENG,DF,Norwich City,19,2000,36,48,30,33,9,6,18,36,50,18,46,29,17,37,85,97,1,19/20
Tammy Abraham,eng ENG,FW,Chelsea,21,1997,24.6,8,4,2,5,1,3,14,21.4,11,20,2,18,6,14,27,0,19/20
Che Adams,sct SCO,FW,Southampton,23,1996,12.3,6,4,1,5,0,1,4,25,3,9,1,8,2,8,10,0,19/20
Adrián,es ESP,GK,Liverpool,32,1987,9.7,1,1,1,0,0,1,1,100,0,0,0,0,0,1,8,3,19/20
Sergio Agüero,ar ARG,FW,Manchester City,31,1988,16.1,7,4,0,4,3,1,8,12.5,7,9,1,8,3,10,2,0,19/20
Albian Ajeti,ch SUI,FW,West Ham,22,1997,1.5,1,0,0,0,1,0,0,,0,0,0,0,0,1,0,0,19/20
Nathan Aké,nl NED,DF,Bournemouth,24,1995,27.8,31,21,23,8,0,14,23,60.9,9,40,29,11,36,67,152,0,19/20
Marc Albrighton,eng ENG,MFDF,Leicester City,29,1989,9.6,24,17,10,13,1,9,30,30,21,19,2,17,10,34,8,0,19/20
Toby Alderweireld,be BEL,DF,Tottenham,30,1989,32.9,40,29,24,13,3,11,24,45.8,13,48,32,16,31,71,172,2,19/20
Trent Alexander-Arnold,eng ENG,DF,Liverpool,20,1998,35.3,55,34,35,17,3,36,78,46.2,42,27,9,18,45,100,84,3,19/20
Alisson,br BRA,GK,Liverpool,26,1992,28.3,0,0,0,0,0,0,2,0,2,0,0,0,1,1,13,3,19/20
Dele Alli,eng ENG,MFFW,Tottenham,23,1996,20.5,34,16,11,20,3,13,37,35.1,24,35,3,32,17,51,17,2,19/20
Miguel Almirón,py PAR,MFFW,Newcastle Utd,25,1994,33.6,60,39,32,20,8,19,52,36.5,33,25,1,24,31,91,25,0,19/20
Marcos Alonso,es ESP,DF,Chelsea,28,1990,15.9,28,16,20,6,2,14,33,42.4,19,18,2,16,20,48,32,0,19/20
Steven Alzate,co COL,MFDF,Brighton,20,1998,13.2,33,19,20,11,2,17,27,63,10,18,3,15,14,47,13,0,19/20
Ibrahim Amadou,fr FRA,DFMF,Norwich City,26,1993,8.4,18,11,9,8,1,3,11,27.3,8,8,5,3,16,34,55,1,19/20
Felipe Anderson,br BRA,MFFW,West Ham,26,1993,16.6,46,32,20,21,5,11,47,23.4,36,19,1,18,22,68,11,0,19/20
Florin Andone,ro ROU,FW,Brighton,26,1993,0.8,1,1,0,1,0,1,1,100,0,1,1,0,0,1,1,0,19/20
Angeliño,es ESP,DF,Manchester City,22,1997,4.7,5,2,3,1,1,5,7,71.4,2,1,0,1,9,14,15,0,19/20
Faustino Anjorin,eng ENG,FW,Chelsea,17,2001,0.2,0,0,0,0,0,0,0,,0,1,0,1,0,0,0,0,19/20
Michail Antonio,jm JAM,FW,West Ham,29,1990,19.6,13,9,5,4,4,4,14,28.6,10,17,2,15,9,22,5,0,19/20
Stuart Armstrong,sct SCO,MF,Southampton,27,1992,19.1,32,19,19,11,2,9,38,23.7,29,22,4,18,11,43,23,1,19/20
Kepa Arrizabalaga,es ESP,GK,Chelsea,24,1994,33,1,1,1,0,0,1,2,50,1,0,0,0,1,2,7,2,19/20
Christian Atsu,gh GHA,MFFW,Newcastle Utd,27,1992,8.3,10,8,5,5,0,5,14,35.7,9,19,0,19,5,15,9,0,19/20
Pierre-Emerick Aubameyang,ga GAB,FW,Arsenal,30,1989,34.8,31,19,10,12,9,12,51,23.5,39,39,1,38,14,45,16,0,19/20
Serge Aurier,ci CIV,DF,Tottenham,26,1992,30,93,69,58,27,8,39,69,56.5,30,38,6,32,47,140,98,2,19/20
Jordan Ayew,gh GHA,FW,Crystal Palace,27,1991,35,48,30,10,22,16,17,49,34.7,32,29,4,25,15,63,21,0,19/20
César Azpilicueta,es ESP,DF,Chelsea,29,1989,35.9,86,56,40,32,14,35,69,50.7,34,56,21,35,67,153,94,0,19/20
Eric Bailly,ci CIV,DF,Manchester Utd,25,1994,1.7,0,0,0,0,0,0,1,0,1,3,3,0,4,4,7,1,19/20
Leighton Baines,eng ENG,DF,Everton,34,1984,4.5,10,6,6,2,2,8,10,80,2,5,2,3,5,15,14,0,19/20
Fabián Balbuena,py PAR,DF,West Ham,27,1991,13.1,17,12,13,3,1,9,25,36,16,15,5,10,26,43,75,3,19/20
George Baldock,gr GRE,DF,Sheffield Utd,26,1993,38,62,43,35,17,10,27,47,57.4,20,26,3,23,34,96,83,3,19/20
Phil Bardsley,sct SCO,DF,Burnley,34,1985,21,49,36,16,24,9,24,37,64.9,13,24,11,13,30,79,73,0,19/20
Ross Barkley,eng ENG,MF,Chelsea,25,1993,12.3,16,9,6,6,4,5,18,27.8,13,7,2,5,7,23,7,0,19/20
Ashley Barnes,eng ENG,FW,Burnley,29,1989,15,10,5,3,5,2,3,9,33.3,6,7,2,5,6,16,9,0,19/20
Harvey Barnes,eng ENG,MFFW,Leicester City,21,1997,23.1,16,11,7,7,2,5,23,21.7,18,13,3,10,8,24,6,1,19/20
Chris Basham,eng ENG,DF,Sheffield Utd,31,1988,36,85,48,58,20,7,48,81,59.3,33,38,15,23,77,162,173,1,19/20
Borja Bastón,es ESP,MFFW,Aston Villa,26,1992,0.2,1,0,0,1,0,0,2,0,2,1,0,1,0,1,0,1,19/20
Michy Batshuayi,be BEL,FW,Chelsea,25,1993,2.7,4,1,2,2,0,0,5,0,5,1,1,0,0,4,1,0,19/20
Jan Bednarek,pl POL,DF,Southampton,23,1996,34,65,38,41,18,6,31,61,50.8,30,44,23,21,77,142,198,4,19/20
Héctor Bellerín,es ESP,DFMF,Arsenal,24,1995,12.9,20,13,7,11,2,11,29,37.9,18,20,4,16,19,39,27,1,19/20
Ryan Bennett,eng ENG,DF,Wolves,29,1990,6.7,4,2,4,0,0,2,6,33.3,4,14,8,6,9,13,29,0,19/20
Ryan Bennett,eng ENG,DF,Leicester City,29,1990,3.7,5,4,3,2,0,4,6,66.7,2,3,1,2,7,12,8,0,19/20
Nabil Bentaleb,dz ALG,MF,Newcastle Utd,24,1994,8.3,23,13,14,9,0,7,25,28,18,9,2,7,19,42,9,1,19/20
Christian Benteke,be BEL,FW,Crystal Palace,28,1990,14,9,5,1,6,2,0,10,0,10,11,4,7,4,13,28,1,19/20
Jóhann Berg Guðmundsson,is ISL,MF,Burnley,28,1990,6.9,4,2,2,2,0,1,8,12.5,7,8,1,7,7,11,9,0,19/20
Sander Berge,no NOR,MF,Sheffield Utd,21,1998,10.5,22,15,3,14,5,5,10,50,5,15,1,14,10,32,16,0,19/20
Steven Bergwijn,nl NED,FWMF,Tottenham,21,1997,7.8,10,6,3,6,1,4,12,33.3,8,12,0,12,1,11,5,0,19/20
Bernard,br BRA,MFFW,Everton,26,1992,14.2,32,22,12,14,6,13,44,29.5,31,22,2,20,16,48,7,0,19/20
Bernardo,br BRA,DFMF,Brighton,24,1995,7.5,27,16,12,9,6,13,17,76.5,4,7,3,4,6,33,24,0,19/20
Ryan Bertrand,eng ENG,DF,Southampton,29,1989,30.5,47,29,22,15,10,26,58,44.8,32,27,12,15,37,84,31,1,19/20
Muhamed Bešić,ba BIH,MF,Sheffield Utd,26,1992,2.8,8,6,4,4,0,2,5,40,3,4,0,4,1,9,6,0,19/20
Philip Billing,dk DEN,MF,Bournemouth,23,1996,28.1,72,46,30,37,5,17,65,26.2,48,59,16,43,66,138,97,1,19/20
Yves Bissouma,ml MLI,MF,Brighton,22,1996,14,49,38,24,22,3,17,40,42.5,23,18,2,16,21,70,23,0,19/20
Willy Boly,ci CIV,DF,Wolves,28,1991,22,57,33,36,21,0,25,43,58.1,18,28,11,17,39,96,108,3,19/20
Gaëtan Bong,cm CMR,DFMF,Brighton,31,1988,0.7,1,0,0,0,1,0,0,,0,1,1,0,0,1,0,0,19/20
Sofiane Boufal,ma MAR,MFFW,Southampton,25,1993,8.5,16,8,6,5,5,6,15,40,9,17,0,17,4,20,1,0,19/20
Jarrod Bowen,eng ENG,FWMF,West Ham,22,1996,10.2,19,15,7,9,3,4,17,23.5,13,6,0,6,16,35,8,0,19/20
Robbie Brady,ie IRL,MF,Burnley,27,1992,5,11,9,5,4,2,3,10,30,7,10,2,8,5,16,8,0,19/20
Jarrad Branthwaite,eng ENG,DF,Everton,17,2002,3.3,8,7,5,3,0,3,5,60,2,6,3,3,2,10,12,0,19/20
Claudio Bravo,cl CHI,GK,Manchester City,36,1983,3.9,0,0,0,0,0,0,0,,0,0,0,0,0,0,1,1,19/20
Armando Broja,al ALB,FW,Chelsea,17,2001,0.1,0,0,0,0,0,0,0,,0,0,0,0,0,0,0,0,19/20
David Brooks,wls WAL,MFFW,Bournemouth,22,1997,5.6,5,5,1,2,2,2,14,14.3,12,5,1,4,2,7,1,0,19/20
Josh Brownhill,eng ENG,MF,Burnley,23,1995,8.9,14,8,5,7,2,5,13,38.5,8,9,4,5,14,28,18,0,19/20
Emi Buendía,ar ARG,FWMF,Norwich City,22,1996,27.4,82,39,57,21,4,38,118,32.2,80,58,5,53,23,105,32,2,19/20
Dan Burn,eng ENG,DF,Brighton,27,1992,32,67,42,35,27,5,25,53,47.2,28,44,20,24,42,109,130,0,19/20
Sam Byram,eng ENG,DF,Norwich City,25,1993,14.4,40,22,24,11,5,18,37,48.6,19,16,8,8,26,66,73,0,19/20
Willy Caballero,ar ARG,GK,Chelsea,37,1981,5,0,0,0,0,0,0,0,,0,0,0,0,0,0,3,0,19/20
Gary Cahill,eng ENG,DF,Crystal Palace,33,1985,24.1,15,8,11,4,0,7,15,46.7,8,34,25,9,18,33,114,1,19/20
Dominic Calvert-Lewin,eng ENG,FW,Everton,22,1997,29.2,7,5,1,4,2,1,10,10,9,15,2,13,6,13,36,0,19/20
Víctor Camarasa,es ESP,FW,Crystal Palace,25,1994,0.1,0,0,0,0,0,0,0,,0,0,0,0,0,0,0,0,19/20
João Cancelo,pt POR,DF,Manchester City,25,1994,13.4,40,24,21,12,7,24,40,60,16,9,2,7,21,61,18,0,19/20
Todd Cantwell,eng ENG,FWMF,Norwich City,21,1998,27.7,51,31,19,27,5,26,73,35.6,47,38,2,36,18,69,35,1,19/20
Étienne Capoue,fr FRA,MF,Watford,31,1988,29.2,75,40,38,30,7,37,85,43.5,48,30,11,19,68,143,61,0,19/20
Andy Carroll,eng ENG,FW,Newcastle Utd,30,1989,7,5,3,3,2,0,2,8,25,6,2,1,1,2,7,24,1,19/20
Jonny Castro,es ESP,MFDF,Wolves,25,1994,32.1,91,55,54,26,11,29,82,35.4,53,45,10,35,53,144,45,2,19/20
Craig Cathcart,nir NIR,DF,Watford,30,1989,27.6,41,26,25,15,1,10,24,41.7,14,19,16,3,25,66,136,1,19/20
Dani Ceballos,es ESP,MF,Arsenal,22,1996,18.8,45,23,26,14,5,18,61,29.5,43,14,3,11,32,77,16,1,19/20
Nathaniel Chalobah,eng ENG,MF,Watford,24,1994,10.3,30,11,13,13,4,12,27,44.4,15,10,4,6,18,48,20,0,19/20
Calum Chambers,eng ENG,DF,Arsenal,24,1995,12.2,26,10,12,8,6,11,16,68.8,5,13,7,6,16,42,43,1,19/20
Ben Chilwell,eng ENG,DF,Leicester City,22,1996,26.4,43,26,28,13,2,23,52,44.2,29,30,6,24,28,71,68,2,19/20
Tahith Chong,nl NED,FWDF,Manchester Utd,19,1999,0.4,0,0,0,0,0,0,0,,0,0,0,0,0,0,0,0,19/20
Hamza Choudhury,eng ENG,MF,Leicester City,21,1997,9.9,17,8,7,8,2,3,25,12,22,15,6,9,24,41,13,0,19/20
Andreas Christensen,dk DEN,DF,Chelsea,23,1996,19.5,38,21,25,12,1,15,21,71.4,6,12,8,4,29,67,56,0,19/20
Ciaran Clark,ie IRL,DF,Newcastle Utd,29,1989,13.2,20,12,18,2,0,9,15,60,6,18,14,4,11,31,82,0,19/20
Leon Clarke,eng ENG,FWMF,Sheffield Utd,34,1985,0.4,0,0,0,0,0,0,0,,0,0,0,0,0,0,2,0,19/20
Tom Cleverley,eng ENG,MF,Watford,29,1989,10.8,28,15,8,14,6,9,36,25,27,13,1,12,10,38,15,0,19/20
Conor Coady,eng ENG,DF,Wolves,26,1993,38,36,23,30,6,0,15,30,50,15,22,15,7,28,64,119,2,19/20
Séamus Coleman,ie IRL,DF,Everton,30,1988,20.4,42,31,24,14,4,19,25,76,6,21,9,12,24,66,43,1,19/20
Aaron Connolly,ie IRL,FW,Brighton,19,2000,14,7,6,1,4,2,3,10,30,7,11,0,11,0,7,3,0,19/20
Lewis Cook,eng ENG,MFFW,Bournemouth,22,1997,15,27,14,15,9,3,10,47,21.3,37,17,5,12,17,44,17,1,19/20
Steve Cook,eng ENG,DF,Bournemouth,28,1991,27,22,11,18,4,0,8,20,40,12,32,23,9,44,66,153,1,19/20
Jack Cork,eng ENG,MF,Burnley,30,1989,29,35,24,10,20,5,12,62,19.4,50,34,12,22,28,63,49,0,19/20
Aaron Cresswell,eng ENG,DF,West Ham,29,1989,30.3,43,26,21,18,4,23,46,50,23,33,10,23,35,78,75,2,19/20
Patrick Cutrone,it ITA,FW,Wolves,21,1998,3.3,4,2,2,1,1,1,5,20,4,1,1,0,2,6,1,0,19/20
Diogo Dalot,pt POR,DFMF,Manchester Utd,20,1999,0.7,3,2,3,0,0,3,4,75,1,1,0,1,2,5,1,0,19/20
Charlie Daniels,eng ENG,DF,Bournemouth,32,1986,1.4,1,1,0,1,0,0,1,0,1,2,0,2,1,2,5,1,19/20
Arnaut Danjuma,nl NED,MF,Bournemouth,22,1997,7,4,2,3,1,0,1,4,25,3,2,0,2,8,12,4,1,19/20
Scott Dann,eng ENG,DF,Crystal Palace,32,1987,14.1,8,4,7,1,0,8,14,57.1,6,9,7,2,14,22,67,0,19/20
Kevin Danso,at AUT,DF,Southampton,20,1998,3.1,6,4,3,3,0,4,7,57.1,3,7,3,4,2,8,7,0,19/20
Ben Davies,wls WAL,DF,Tottenham,26,1993,15.9,28,15,13,11,4,7,21,33.3,14,28,12,16,22,50,47,0,19/20
Tom Davies,eng ENG,MF,Everton,21,1998,22.5,38,17,12,22,4,17,55,30.9,38,12,4,8,35,73,28,0,19/20
Keinan Davis,eng ENG,FW,Aston Villa,21,1998,6.1,1,1,0,1,0,0,3,0,3,4,0,4,0,1,3,0,19/20
Craig Dawson,eng ENG,DF,Watford,29,1990,26.2,29,18,16,13,0,17,31,54.8,14,41,32,9,34,63,116,0,19/20
Kevin De Bruyne,be BEL,MF,Manchester City,28,1991,31,45,24,8,20,17,18,66,27.3,48,26,4,22,18,63,24,2,19/20
Troy Deeney,eng ENG,FW,Watford,31,1988,24.7,19,12,6,10,3,6,29,20.7,23,13,1,12,11,30,27,0,19/20
Fabian Delph,eng ENG,MF,Everton,29,1989,13.2,26,12,10,13,3,9,22,40.9,13,12,3,9,15,41,19,1,19/20
Leander Dendoncker,be BEL,MFDF,Wolves,24,1995,31.1,68,31,41,19,8,28,67,41.8,39,39,12,27,38,106,64,2,19/20
Gerard Deulofeu,es ESP,FW,Watford,25,1994,23.3,33,16,18,9,6,12,59,20.3,47,10,0,10,25,58,6,0,19/20
Eric Dier,eng ENG,DFMF,Tottenham,25,1994,14.9,21,12,10,10,1,10,20,50,10,14,9,5,21,42,65,0,19/20
Lucas Digne,fr FRA,DF,Everton,26,1993,33.7,73,49,49,19,5,33,68,48.5,35,39,10,29,42,115,108,0,19/20
Issa Diop,fr FRA,DF,West Ham,22,1997,30.7,27,15,18,9,0,16,25,64,9,37,21,16,47,74,166,2,19/20
Moussa Djenepo,ml MLI,MFDF,Southampton,21,1998,10.3,27,21,13,9,5,11,21,52.4,10,15,1,14,9,36,9,0,19/20
Matt Doherty,ie IRL,MFDF,Wolves,27,1992,31.5,55,29,34,17,4,27,41,65.9,14,34,4,30,40,95,52,1,19/20
Abdoulaye Doucouré,ml MLI,MF,Watford,26,1993,35.1,64,30,29,29,6,16,57,28.1,41,46,8,38,31,95,32,0,19/20
Thomas Doyle,eng ENG,MF,Manchester City,17,2001,0.2,0,0,0,0,0,0,1,0,1,0,0,0,0,0,0,0,19/20
Danny Drinkwater,eng ENG,MF,Aston Villa,29,1990,2.9,5,3,3,2,0,2,18,11.1,16,5,0,5,5,10,5,1,19/20
Danny Drinkwater,eng ENG,MF,Burnley,29,1990,0.6,2,1,1,1,0,0,1,0,1,0,0,0,1,3,0,0,19/20
Josip Drmić,ch SUI,FW,Norwich City,26,1992,7.2,3,2,1,2,0,0,8,0,8,6,0,6,1,4,5,1,19/20
Martin Dúbravka,sk SVK,GK,Newcastle Utd,30,1989,38,1,1,1,0,0,1,2,50,1,2,0,2,1,2,17,5,19/20
Ondrej Duda,sk SVK,MF,Norwich City,24,1994,8,18,11,9,6,3,7,16,43.8,9,10,2,8,6,24,8,0,19/20
Shane Duffy,ie IRL,DF,Brighton,27,1992,13.8,18,9,14,4,0,6,17,35.3,11,13,7,6,21,39,72,0,19/20
Paul Dummett,wls WAL,DF,Newcastle Utd,27,1991,13.6,27,17,19,7,1,21,27,77.8,6,23,9,14,23,50,69,0,19/20
Lewis Dunk,eng ENG,DF,Brighton,27,1991,35.9,40,24,23,17,0,15,34,44.1,19,55,33,22,55,95,125,2,19/20
Ederson,br BRA,GK,Manchester City,25,1993,34.1,2,2,2,0,0,2,5,40,3,0,0,0,3,5,16,6,19/20
John Egan,ie IRL,DF,Sheffield Utd,26,1992,35.4,44,27,34,10,0,25,45,55.6,20,39,27,12,58,102,171,4,19/20
Harvey Elliott,eng ENG,DF,Liverpool,16,2003,0.1,0,0,0,0,0,0,0,,0,0,0,0,0,0,0,0,19/20
Ahmed Elmohamady,eg EGY,DF,Aston Villa,31,1987,11.5,19,9,10,7,2,10,21,47.6,11,11,5,6,13,32,25,1,19/20
Björn Engels,be BEL,DF,Aston Villa,24,1994,16.1,11,6,8,2,1,8,13,61.5,5,18,17,1,28,39,86,3,19/20
Christian Eriksen,dk DEN,MFFW,Tottenham,27,1992,12.2,19,9,10,8,1,7,24,29.2,17,10,1,9,12,31,16,0,19/20
Jonny Evans,nir NIR,DF,Leicester City,31,1988,37.6,48,34,33,14,1,28,39,71.8,11,33,18,15,57,105,174,4,19/20
Łukasz Fabiański,pl POL,GK,West Ham,34,1985,23.5,2,2,2,0,0,2,4,50,2,0,0,0,1,3,5,3,19/20
Fabinho,br BRA,MF,Liverpool,25,1993,23.1,62,35,20,35,7,26,67,38.8,41,25,2,23,34,96,19,1,19/20
Ralf Fährmann,de GER,GK,Norwich City,30,1988,0.2,0,0,0,0,0,0,0,,0,0,0,0,0,0,0,0,19/20
Akin Famewo,eng ENG,MF,Norwich City,20,1998,0,0,0,0,0,0,0,0,,0,0,0,0,0,0,0,0,19/20
Kiko Femenía,es ESP,DF,Watford,28,1991,24.9,68,38,49,17,2,43,80,53.8,37,16,2,14,36,104,49,0,19/20
Bruno Fernandes,pt POR,MF,Manchester Utd,24,1994,13.2,22,12,9,9,4,5,38,13.2,33,6,0,6,11,33,16,0,19/20
Gedson Fernandes,pt POR,MFDF,Tottenham,20,1999,0.8,2,0,2,0,0,0,2,0,2,2,0,2,1,3,0,0,19/20
Federico Fernández,ar ARG,DF,Newcastle Utd,30,1989,29.1,42,25,30,10,2,23,46,50,23,41,28,13,24,66,190,2,19/20
Fernandinho,br BRA,DF,Manchester City,34,1985,26.6,50,35,32,16,2,29,48,60.4,19,28,16,12,25,75,82,0,19/20
Roberto Firmino,br BRA,FW,Liverpool,27,1991,33.2,37,19,8,14,15,10,43,23.3,33,34,3,31,7,44,11,1,19/20
John Fleck,sct SCO,MF,Sheffield Utd,27,1991,28,36,25,13,14,9,22,64,34.4,42,25,3,22,24,60,26,0,19/20
Phil Foden,eng ENG,FWMF,Manchester City,19,2000,10,14,10,4,6,4,6,19,31.6,13,5,0,5,6,20,2,0,19/20
Pablo Fornals,es ESP,MFFW,West Ham,23,1996,24.1,46,28,21,18,7,19,64,29.7,45,35,1,34,25,71,15,0,19/20
Ben Foster,eng ENG,GK,Watford,36,1983,38,1,0,1,0,0,1,3,33.3,2,1,0,1,0,1,16,2,19/20
Timothy Fosu-Mensah,nl NED,DF,Manchester Utd,21,1998,1.5,1,1,0,1,0,1,4,25,3,0,0,0,4,5,1,0,19/20
Dimitri Foulquier,fr FRA,DFMF,Watford,26,1993,0.7,1,0,1,0,0,0,0,,0,1,0,1,2,3,2,0,19/20
Juan Foyth,ar ARG,DF,Tottenham,21,1998,0.8,7,3,5,2,0,3,4,75,1,1,0,1,1,8,3,1,19/20
Simon Francis,eng ENG,DF,Bournemouth,34,1985,10.8,13,9,11,2,0,11,21,52.4,10,17,12,5,20,33,71,0,19/20
Ryan Fraser,sct SCO,MFFW,Bournemouth,25,1994,23,12,6,5,5,2,7,22,31.8,15,15,3,12,15,27,24,0,19/20
Fred,br BRA,MF,Manchester Utd,26,1993,24,60,32,33,22,5,25,100,25,75,44,8,36,38,98,32,0,19/20
Ryan Fredericks,eng ENG,DF,West Ham,26,1992,24.9,82,56,59,18,5,41,64,64.1,23,20,10,10,24,106,73,1,19/20
Kieron Freeman,wls WAL,FW,Sheffield Utd,27,1992,0.1,0,0,0,0,0,0,0,,0,0,0,0,0,0,0,0,19/20
Luke Freeman,eng ENG,MF,Sheffield Utd,27,1992,4.1,6,4,2,2,2,2,8,25,6,1,0,1,10,16,6,0,19/20
Christian Fuchs,at AUT,DF,Leicester City,33,1986,8.6,14,9,8,6,0,8,19,42.1,11,8,3,5,17,31,33,1,19/20
Eric García,es ESP,DF,Manchester City,18,2001,8.8,6,1,4,2,0,5,9,55.6,4,2,0,2,18,24,33,0,19/20
James Garner,eng ENG,MF,Manchester Utd,18,2001,0.1,0,0,0,0,0,0,1,0,1,0,0,0,0,0,1,0,19/20
Dwight Gayle,eng ENG,FW,Newcastle Utd,28,1990,9.4,12,10,4,6,2,4,8,50,4,5,0,5,2,14,9,0,19/20
Paulo Gazzaniga,ar ARG,GK,Tottenham,27,1992,17.9,0,0,0,0,0,0,0,,0,0,0,0,1,1,4,1,19/20
Jean-Philippe Gbamin,ci CIV,MF,Everton,23,1995,1.5,4,3,1,1,2,1,2,50,1,1,0,1,1,5,4,0,19/20
David de Gea,es ESP,GK,Manchester Utd,28,1990,38,0,0,0,0,0,0,0,,0,0,0,0,0,0,7,4,19/20
Anwar El Ghazi,nl NED,FWMF,Aston Villa,24,1995,22.8,20,11,12,5,3,8,26,30.8,18,10,1,9,13,33,16,1,19/20
Morgan Gibbs-White,eng ENG,MFFW,Wolves,19,2000,1.4,0,0,0,0,0,0,0,,0,0,0,0,2,2,0,0,19/20
Billy Gilmour,sct SCO,MF,Chelsea,18,2001,2.2,5,2,3,2,0,2,4,50,2,2,0,2,3,8,3,1,19/20
Olivier Giroud,fr FRA,FW,Chelsea,32,1986,11,8,3,2,5,1,1,11,9.1,10,14,1,13,2,10,13,0,19/20
Ben Godfrey,eng ENG,DF,Norwich City,21,1998,29.4,22,14,18,3,1,10,18,55.6,8,41,37,4,25,47,152,3,19/20
André Gomes,pt POR,MF,Everton,26,1993,16.2,22,15,7,11,4,8,62,12.9,54,20,3,17,7,29,7,0,19/20
Angel Gomes,eng ENG,MF,Manchester Utd,18,2000,0.2,0,0,0,0,0,0,0,,0,1,0,1,0,0,0,0,19/20
Joe Gomez,eng ENG,DF,Liverpool,22,1997,22.3,23,16,17,6,0,9,20,45,11,15,8,7,38,61,64,2,19/20
Anthony Gordon,eng ENG,MFFW,Everton,18,2001,4.9,11,7,5,6,0,5,15,33.3,10,6,2,4,8,19,4,0,19/20
Dan Gosling,eng ENG,MF,Bournemouth,29,1990,14,26,10,14,9,3,6,27,22.2,21,31,11,20,20,46,26,0,19/20
Andre Gray,jm JAM,FW,Watford,28,1991,8.4,4,3,0,2,2,1,3,33.3,2,4,1,3,1,5,2,0,19/20
Demarai Gray,eng ENG,MFFW,Leicester City,23,1996,6.9,12,6,6,6,0,6,12,50,6,7,0,7,5,17,4,0,19/20
Jack Grealish,eng ENG,FWMF,Aston Villa,23,1995,35.9,29,19,12,12,5,13,34,38.2,21,33,12,21,22,51,22,1,19/20
Mason Greenwood,eng ENG,FW,Manchester Utd,17,2001,14.7,17,11,5,6,6,5,20,25,15,9,0,9,6,23,6,1,19/20
Pascal Groß,de GER,MFFW,Brighton,28,1991,20,36,13,8,21,7,14,39,35.9,25,25,3,22,9,45,7,0,19/20
Vicente Guaita,es ESP,GK,Crystal Palace,32,1987,35,1,1,1,0,0,1,2,50,1,0,0,0,0,1,18,3,19/20
Mattéo Guendouzi,fr FRA,MF,Arsenal,20,1999,19.4,31,16,14,13,4,14,43,32.6,29,21,7,14,29,60,38,2,19/20
Frederic Guilbert,fr FRA,DFMF,Aston Villa,24,1994,22.7,74,43,48,20,6,36,67,53.7,31,33,10,23,49,123,74,2,19/20
İlkay Gündoğan,de GER,MF,Manchester City,28,1990,22.4,27,16,9,11,7,9,41,22,32,17,5,12,31,58,13,0,19/20
Angus Gunn,sct SCO,GK,Southampton,23,1996,10,1,1,1,0,0,1,3,33.3,2,0,0,0,0,1,1,0,19/20
Sébastien Haller,ci CIV,FW,West Ham,25,1994,25.2,22,15,8,10,4,3,30,10,27,19,5,14,8,30,27,0,19/20
Grant Hanley,sct SCO,DF,Norwich City,27,1991,14,24,15,17,7,0,8,14,57.1,6,25,18,7,31,55,77,1,19/20
Kortney Hause,eng ENG,DF,Aston Villa,24,1995,17.2,21,9,15,5,1,8,15,53.3,7,27,19,8,20,41,98,4,19/20
Isaac Hayden,eng ENG,MF,Newcastle Utd,24,1995,24.7,55,27,33,17,5,20,50,40,30,24,7,17,38,93,38,0,19/20
Tom Heaton,eng ENG,GK,Aston Villa,33,1986,19.9,3,2,3,0,0,3,4,75,1,0,0,0,0,3,6,0,19/20
Dean Henderson,eng ENG,GK,Sheffield Utd,22,1997,36,0,0,0,0,0,0,0,,0,0,0,0,1,1,13,1,19/20
Jordan Henderson,eng ENG,MF,Liverpool,29,1990,24.9,63,41,18,33,12,22,55,40,33,22,4,18,30,93,21,2,19/20
Jeff Hendrick,ie IRL,MF,Burnley,27,1992,21.5,18,10,7,8,3,7,27,25.9,20,21,8,13,20,38,20,0,19/20
Wayne Hennessey,wls WAL,GK,Crystal Palace,32,1987,3,0,0,0,0,0,0,0,,0,0,0,0,1,1,3,1,19/20
Javier Hernández,mx MEX,FW,West Ham,31,1988,1.2,0,0,0,0,0,0,1,0,1,0,0,0,1,1,0,0,19/20
Onel Hernández,cu CUB,FWMF,Norwich City,26,1993,15.4,27,19,13,11,3,9,31,29,22,12,1,11,19,46,10,0,19/20
Son Heung-min,kr KOR,FW,Tottenham,27,1992,27.5,23,15,10,11,2,9,57,15.8,48,23,0,23,19,42,18,1,19/20
George Hirst,eng ENG,MFDF,Leicester City,20,1999,0.1,0,0,0,0,0,0,0,,0,0,0,0,0,0,0,0,19/20
Rob Holding,eng ENG,DF,Arsenal,23,1995,6.5,4,2,3,1,0,1,3,33.3,2,10,6,4,5,9,45,1,19/20
José Holebas,gr GRE,DF,Watford,35,1984,11.4,26,15,19,7,0,9,28,32.1,19,11,4,7,3,29,33,0,19/20
Mason Holgate,eng ENG,DF,Everton,22,1996,22.8,44,26,30,13,1,21,31,67.7,10,26,13,13,34,78,97,0,19/20
Nathan Holland,eng ENG,MF,West Ham,21,1998,0.4,3,1,2,1,0,0,0,,0,1,0,1,0,3,0,0,19/20
Conor Hourihane,ie IRL,MF,Aston Villa,28,1991,17,16,10,4,8,4,10,25,40,15,19,4,15,9,25,31,0,19/20
Callum Hudson-Odoi,eng ENG,FWMF,Chelsea,18,2000,9.6,10,4,4,5,1,1,7,14.3,6,9,0,9,5,15,4,1,19/20
Will Hughes,eng ENG,MF,Watford,24,1995,25,75,47,24,41,10,25,67,37.3,42,48,8,40,37,112,28,0,19/20
Pierre Højbjerg,dk DEN,MF,Southampton,23,1995,30.6,80,49,34,38,8,39,91,42.9,52,44,5,39,46,126,54,2,19/20
Jordon Ibe,eng ENG,DF,Bournemouth,23,1995,0.6,2,2,2,0,0,1,1,100,0,0,0,0,0,2,1,0,19/20
Adam Idah,ie IRL,FWMF,Norwich City,18,2001,2.5,2,2,1,0,1,2,3,66.7,1,4,0,4,0,2,1,0,19/20
Odion Ighalo,ng NGA,FW,Manchester Utd,30,1989,1.1,2,2,0,2,0,1,3,33.3,2,1,1,0,0,2,0,0,19/20
Kelechi Iheanacho,ng NGA,FW,Leicester City,22,1996,10.7,3,1,1,2,0,1,9,11.1,8,8,1,7,3,6,8,0,19/20
Danny Ings,eng ENG,FW,Southampton,27,1992,31.2,42,25,16,16,10,13,67,19.4,54,62,4,58,9,51,30,1,19/20
Alex Iwobi,ng NGA,MFFW,Everton,23,1996,17.7,25,17,8,15,2,12,33,36.4,21,18,2,16,14,39,10,1,19/20
Phil Jagielka,eng ENG,DF,Sheffield Utd,36,1982,2.7,5,4,3,2,0,1,3,33.3,2,5,5,0,4,9,19,0,19/20
Alireza Jahanbakhsh,ir IRN,FWMF,Brighton,25,1993,3.5,8,4,3,2,3,0,2,0,2,5,0,5,3,11,2,0,19/20
Daniel James,wls WAL,FW,Manchester Utd,21,1997,25.4,20,10,5,10,5,7,45,15.6,38,23,4,19,7,27,12,0,19/20
Matty James,eng ENG,MF,Leicester City,28,1991,0.1,0,0,0,0,0,0,0,,0,0,0,0,0,0,0,0,19/20
Reece James,eng ENG,DF,Chelsea,19,1999,16.8,36,23,18,14,4,11,29,37.9,18,19,8,11,22,58,28,0,19/20
Daryl Janmaat,nl NED,DF,Watford,30,1989,6.7,14,10,8,6,0,6,13,46.2,7,7,2,5,7,21,23,0,19/20
Gabriel Jesus,br BRA,FW,Manchester City,22,1997,22.6,17,10,4,5,8,7,25,28,18,26,1,25,11,28,6,0,19/20
Raúl Jiménez,mx MEX,FW,Wolves,28,1991,36,20,12,6,10,4,3,31,9.7,28,26,0,26,16,36,34,1,19/20
João Pedro,br BRA,FWMF,Watford,17,2001,0.3,0,0,0,0,0,0,0,,0,0,0,0,0,0,0,0,19/20
Joelinton,br BRA,FW,Newcastle Utd,22,1996,29.8,34,20,7,22,5,9,32,28.1,23,32,6,26,11,45,30,0,19/20
Ben Johnson,eng ENG,DF,West Ham,19,2000,3,8,4,7,1,0,7,10,70,3,5,2,3,3,11,11,0,19/20
Curtis Jones,eng ENG,MF,Liverpool,18,2001,1.4,4,4,0,1,3,3,4,75,1,2,0,2,2,6,1,0,19/20
Phil Jones,eng ENG,DF,Manchester Utd,27,1992,1.5,2,2,1,1,0,1,1,100,0,2,0,2,2,4,9,1,19/20
Bruno Jordão,pt POR,FW,Wolves,20,1998,0.1,0,0,0,0,0,0,0,,0,1,0,1,0,0,0,0,19/20
Jorginho,it ITA,MF,Chelsea,27,1991,26.4,66,40,24,34,8,35,91,38.5,56,30,5,25,64,130,27,2,19/20
Jota,es ESP,FWMF,Aston Villa,28,1991,3.7,3,1,2,0,1,2,5,40,3,1,0,1,3,6,6,0,19/20
Diogo Jota,pt POR,FW,Wolves,22,1996,25.4,28,15,16,10,2,12,48,25,36,17,0,17,9,37,10,2,19/20
James Justin,eng ENG,DFMF,Leicester City,21,1998,11.2,36,17,22,14,0,15,25,60,10,15,7,8,11,47,30,0,19/20
Christian Kabasele,be BEL,DF,Watford,28,1991,25,37,24,26,11,0,17,32,53.1,15,31,23,8,36,73,127,0,19/20
Harry Kane,eng ENG,FW,Tottenham,26,1993,28.7,18,12,3,12,3,4,17,23.5,13,17,7,10,6,24,30,0,19/20
N'Golo Kanté,fr FRA,MF,Chelsea,28,1991,19.2,44,20,22,14,8,17,36,47.2,19,29,5,24,44,88,32,2,19/20
Moise Kean,it ITA,FW,Everton,19,2000,9.5,6,6,5,1,0,0,0,,0,4,0,4,5,11,1,1,19/20
Michael Keane,eng ENG,DF,Everton,26,1993,28.4,31,16,18,12,1,14,24,58.3,10,35,28,7,44,75,152,0,19/20
Naby Keïta,gn GUI,MF,Liverpool,24,1995,9.1,30,14,8,16,6,11,26,42.3,15,18,0,18,10,40,4,0,19/20
Lloyd Kelly,eng ENG,DF,Bournemouth,20,1998,7.1,7,3,3,4,0,6,7,85.7,1,9,5,4,6,13,15,1,19/20
Martin Kelly,eng ENG,DF,Crystal Palace,29,1990,17.2,23,18,19,4,0,14,31,45.2,17,18,10,8,16,39,86,1,19/20
Max Kilman,eng ENG,DF,Wolves,22,1997,2.1,4,2,1,3,0,2,2,100,0,1,1,0,4,8,7,0,19/20
Joshua King,no NOR,FWMF,Bournemouth,27,1992,22.3,16,6,4,8,4,4,16,25,12,20,3,17,8,24,9,0,19/20
Timm Klose,ch SUI,DF,Norwich City,31,1988,6.5,8,2,5,2,1,7,11,63.6,4,6,6,0,7,15,29,0,19/20
Jonathan Kodjia,ci CIV,FW,Aston Villa,29,1989,1.3,0,0,0,0,0,0,1,0,1,0,0,0,0,0,1,0,19/20
Sead Kolašinac,ba BIH,DF,Arsenal,26,1993,18.9,29,16,18,6,5,12,23,52.2,11,14,4,10,25,54,34,1,19/20
Ezri Konsa,eng ENG,DF,Aston Villa,21,1997,22.7,18,9,12,6,0,7,16,43.8,9,34,24,10,25,43,70,2,19/20
Cheikhou Kouyaté,sn SEN,MFDF,Crystal Palace,29,1989,28.1,67,32,43,20,4,26,48,54.2,22,35,11,24,43,110,58,1,19/20
Mateo Kovačić,hr CRO,MF,Chelsea,25,1994,23,63,38,29,32,2,26,65,40,39,15,1,14,22,85,16,1,19/20
Emil Krafth,se SWE,DF,Newcastle Utd,24,1994,11.3,18,12,15,2,1,9,20,45,11,11,8,3,8,26,45,0,19/20
Tim Krul,nl NED,GK,Norwich City,31,1988,36,0,0,0,0,0,0,1,0,1,2,0,2,1,1,13,1,19/20
Alexandre Lacazette,fr FRA,FW,Arsenal,28,1991,20.8,31,16,8,21,2,9,24,37.5,15,14,0,14,7,38,15,0,19/20
Adam Lallana,eng ENG,MFFW,Liverpool,31,1988,4.2,19,9,7,9,3,6,21,28.6,15,7,0,7,5,24,3,0,19/20
Érik Lamela,ar ARG,MFFW,Tottenham,27,1992,13.5,24,20,9,13,2,2,21,9.5,19,12,3,9,8,32,10,0,19/20
Tariq Lamptey,gh GHA,DF,Chelsea,18,2000,0.4,2,2,1,1,0,2,2,100,0,0,0,0,0,2,0,0,19/20
Tariq Lamptey,gh GHA,DF,Brighton,18,2000,6.5,7,6,6,1,0,2,9,22.2,7,6,0,6,16,23,17,0,19/20
Henri Lansbury,eng ENG,MF,Aston Villa,28,1990,2.2,6,2,3,1,2,2,8,25,6,4,0,4,0,6,3,0,19/20
Manuel Lanzini,ar ARG,MFFW,West Ham,26,1993,15.3,14,9,6,6,2,7,39,17.9,32,9,1,8,10,24,3,0,19/20
Aymeric Laporte,es ESP,DF,Manchester City,25,1994,12.2,13,6,6,7,0,4,9,44.4,5,6,5,1,20,33,26,1,19/20
Jamaal Lascelles,eng ENG,DF,Newcastle Utd,25,1993,23.1,14,3,10,4,0,4,9,44.4,5,23,20,3,28,42,116,1,19/20
Valentino Lazaro,at AUT,DFMF,Newcastle Utd,23,1996,5.3,13,9,11,2,0,11,18,61.1,7,2,0,2,3,16,4,0,19/20
Moritz Leitner,de GER,MF,Norwich City,26,1992,7.6,16,9,8,7,1,9,25,36,16,14,4,10,9,25,10,1,19/20
Florian Lejeune,fr FRA,DF,Newcastle Utd,28,1991,4.9,8,2,6,2,0,4,7,57.1,3,6,2,4,10,18,15,2,19/20
Aaron Lennon,eng ENG,MF,Burnley,32,1987,5.5,14,8,7,4,3,7,10,70,3,6,1,5,8,22,3,0,19/20
Bernd Leno,de GER,GK,Arsenal,27,1992,29.4,0,0,0,0,0,0,2,0,2,0,0,0,0,0,9,2,19/20
Jefferson Lerma,co COL,MF,Bournemouth,24,1994,30,54,32,17,31,6,22,48,45.8,26,28,12,16,57,111,54,1,19/20
Jamal Lewis,nir NIR,DF,Norwich City,21,1998,25.6,51,35,42,6,3,22,36,61.1,14,27,12,15,25,76,68,0,19/20
Victor Lindelöf,se SWE,DF,Manchester Utd,25,1994,34.4,29,15,16,12,1,17,20,85,3,25,16,9,26,55,129,0,19/20
Jesse Lingard,eng ENG,MFFW,Manchester Utd,26,1992,10.4,15,8,6,4,5,5,18,27.8,13,5,0,5,3,18,0,0,19/20
Hugo Lloris,fr FRA,GK,Tottenham,32,1986,20.1,0,0,0,0,0,0,0,,0,0,0,0,1,1,3,2,19/20
Giovani Lo Celso,ar ARG,MFFW,Tottenham,23,1996,16.6,51,29,12,33,6,12,59,20.3,47,20,4,16,9,60,19,0,19/20
Jürgen Locadia,nl NED,FWMF,Brighton,25,1993,1,0,0,0,0,0,0,0,,0,0,0,0,0,0,0,0,19/20
Ruben Loftus-Cheek,eng ENG,MFFW,Chelsea,23,1996,2.3,0,0,0,0,0,0,2,0,2,1,1,0,2,2,2,0,19/20
Kevin Long,ie IRL,DF,Burnley,28,1990,6.3,7,5,6,1,0,4,9,44.4,5,9,7,2,4,11,31,0,19/20
Shane Long,ie IRL,FW,Southampton,32,1987,15.5,19,10,5,8,6,7,19,36.8,12,12,0,12,4,23,16,0,19/20
Matthew Longstaff,eng ENG,MF,Newcastle Utd,19,2000,6.4,3,1,2,1,0,3,14,21.4,11,4,1,3,5,8,3,0,19/20
Sean Longstaff,eng ENG,MF,Newcastle Utd,21,1997,15.3,35,19,17,16,2,20,50,40,30,23,5,18,19,54,20,2,19/20
Dejan Lovren,hr CRO,DF,Liverpool,30,1989,8.6,13,8,10,3,0,7,12,58.3,5,9,6,3,10,23,42,0,19/20
Matthew Lowton,eng ENG,DF,Burnley,30,1989,17,41,22,20,18,3,22,33,66.7,11,20,6,14,27,68,57,1,19/20
David Luiz,br BRA,DF,Arsenal,32,1987,31.2,28,16,14,14,0,13,24,54.2,11,42,37,5,32,60,133,2,19/20
Douglas Luiz,br BRA,MF,Aston Villa,21,1998,29,46,24,25,17,4,19,65,29.2,46,42,15,27,36,82,54,1,19/20
John Lundstram,eng ENG,MF,Sheffield Utd,25,1994,27.3,46,30,18,21,7,21,65,32.3,44,18,4,14,33,79,46,1,19/20
Alexis Mac Allister,ar ARG,MFFW,Brighton,20,1998,3.9,9,5,4,3,2,5,9,55.6,4,12,0,12,1,10,2,0,19/20
James Maddison,eng ENG,MF,Leicester City,22,1996,29.2,59,30,13,31,15,23,68,33.8,45,16,0,16,9,68,7,1,19/20
Harry Maguire,eng ENG,DF,Manchester Utd,26,1993,38,37,23,23,14,0,18,34,52.9,16,31,22,9,72,109,159,0,19/20
Riyad Mahrez,dz ALG,FWMF,Manchester City,28,1991,21.6,28,14,11,9,8,11,38,28.9,27,31,1,30,18,46,8,2,19/20
Ainsley Maitland-Niles,eng ENG,DF,Arsenal,21,1997,15.4,41,23,34,5,2,22,43,51.2,21,12,3,9,28,69,38,0,19/20
Sadio Mané,sn SEN,FW,Liverpool,27,1992,30.5,44,32,9,20,15,13,40,32.5,27,19,0,19,13,57,11,2,19/20
Javier Manquillo,es ESP,DF,Newcastle Utd,25,1994,17.8,39,26,27,8,4,24,38,63.2,14,14,2,12,18,57,56,0,19/20
Solly March,eng ENG,FWMF,Brighton,25,1994,12.7,25,12,16,6,3,9,19,47.4,10,16,4,12,20,45,14,2,19/20
Pablo Marí,es ESP,DF,Arsenal,25,1993,1.3,2,1,2,0,0,0,0,,0,0,0,0,1,3,10,0,19/20
Adrian Mariappa,jm JAM,DF,Watford,32,1986,16.8,20,14,15,4,1,11,30,36.7,19,22,7,15,11,31,73,0,19/20
Anthony Martial,fr FRA,FW,Manchester Utd,23,1995,29.2,15,12,1,4,10,1,16,6.3,15,18,1,17,5,20,17,0,19/20
David Martin,eng ENG,GK,West Ham,33,1986,4.8,0,0,0,0,0,0,0,,0,0,0,0,0,0,1,1,19/20
Josh Martin,eng ENG,FWMF,Norwich City,17,2001,0.4,1,0,0,0,1,0,0,,0,1,0,1,1,2,0,0,19/20
Martinelli,br BRA,FW,Arsenal,18,2001,7.4,20,15,10,6,4,7,20,35,13,15,1,14,3,23,8,0,19/20
Emiliano Martínez,ar ARG,GK,Arsenal,26,1992,8.6,0,0,0,0,0,0,0,,0,0,0,0,0,0,1,0,19/20
Adam Masina,ma MAR,DF,Watford,25,1994,20.2,38,22,24,11,3,14,37,37.8,23,26,12,14,28,66,66,0,19/20
Arthur Masuaku,cd COD,DF,West Ham,25,1993,10.4,41,23,24,13,4,23,39,59,16,19,5,14,14,55,23,0,19/20
Juan Mata,es ESP,MFFW,Manchester Utd,31,1988,8.4,7,3,1,5,1,2,7,28.6,5,5,1,4,0,7,2,0,19/20
Nemanja Matić,rs SRB,MF,Manchester Utd,30,1988,17.6,46,24,23,19,4,20,43,46.5,23,21,8,13,22,68,28,1,19/20
Joël Matip,cm CMR,DF,Liverpool,27,1991,7.8,13,9,4,7,2,4,11,36.4,7,8,4,4,12,25,38,0,19/20
Neal Maupay,fr FRA,FW,Brighton,22,1996,30.7,20,12,1,13,6,9,29,31,20,24,0,24,4,24,10,0,19/20
James McArthur,sct SCO,MF,Crystal Palace,31,1987,34.3,88,51,43,34,11,37,106,34.9,69,69,19,50,60,148,56,0,19/20
Oliver McBurnie,sct SCO,FW,Sheffield Utd,23,1996,23.5,37,22,6,27,4,11,40,27.5,29,25,3,22,15,52,43,0,19/20
Alex McCarthy,eng ENG,GK,Southampton,29,1989,28,1,1,1,0,0,1,1,100,0,1,0,1,0,1,11,3,19/20
James McCarthy,ie IRL,MF,Crystal Palace,28,1990,18.7,82,47,36,36,10,40,76,52.6,36,24,5,19,24,106,11,0,19/20
John McGinn,sct SCO,MF,Aston Villa,24,1994,25.7,53,35,19,23,11,18,62,29,44,25,1,24,25,78,18,0,19/20
David McGoldrick,ie IRL,FW,Sheffield Utd,31,1987,20.2,41,26,9,24,8,5,20,25,15,14,2,12,3,44,23,0,19/20
Michael McGovern,nir NIR,GK,Norwich City,35,1984,1.8,0,0,0,0,0,0,0,,0,0,0,0,0,0,1,1,19/20
Kenny McLean,sct SCO,MF,Norwich City,27,1992,33,44,29,20,18,6,14,42,33.3,28,32,7,25,38,82,67,2,19/20
Dwight McNeil,eng ENG,MF,Burnley,19,1999,37.1,47,33,18,22,7,23,71,32.4,48,60,8,52,30,77,34,0,19/20
Scott McTominay,sct SCO,MF,Manchester Utd,22,1996,19.7,43,22,14,25,4,17,32,53.1,15,25,5,20,31,74,34,2,19/20
Ben Mee,eng ENG,DF,Burnley,29,1989,32,41,22,25,16,0,17,29,58.6,12,42,31,11,42,83,165,2,19/20
Benjamin Mendy,fr FRA,DF,Manchester City,25,1994,16.6,18,15,7,7,4,9,27,33.3,18,10,2,8,16,34,21,3,19/20
Nampalys Mendy,sn SEN,MF,Leicester City,27,1992,3.2,7,5,4,1,2,4,5,80,1,4,1,3,6,13,6,0,19/20
Chris Mepham,wls WAL,DF,Bournemouth,21,1997,10.1,20,9,13,7,0,11,14,78.6,3,17,11,6,17,37,62,1,19/20
Max Meyer,de GER,MFFW,Crystal Palace,23,1995,7.3,19,11,10,9,0,8,18,44.4,10,6,1,5,7,26,4,0,19/20
Luka Milivojević,rs SRB,MF,Crystal Palace,28,1991,27.9,61,32,32,25,4,35,84,41.7,49,30,7,23,42,103,39,4,19/20
James Milner,eng ENG,MFDF,Liverpool,33,1986,10.4,16,10,3,10,3,6,26,23.1,20,12,3,9,7,23,17,1,19/20
Yerry Mina,co COL,DF,Everton,24,1994,25.4,39,22,25,12,2,18,24,75,6,20,14,6,28,67,102,1,19/20
Takumi Minamino,jp JPN,FWMF,Liverpool,24,1995,2.8,3,3,0,2,1,2,10,20,8,3,0,3,0,3,3,0,19/20
Tyrone Mings,eng ENG,DF,Aston Villa,26,1993,32.2,15,11,11,3,1,10,13,76.9,3,56,48,8,30,45,190,4,19/20
Tyrick Mitchell,eng ENG,DF,Crystal Palace,19,1999,2.2,5,2,2,2,1,1,7,14.3,6,2,0,2,2,7,3,0,19/20
Henrikh Mkhitaryan,am ARM,FW,Arsenal,30,1989,1.2,0,0,0,0,0,0,2,0,2,3,0,3,0,0,1,0,19/20
Nacho Monreal,es ESP,DF,Arsenal,33,1986,3,1,1,1,0,0,1,3,33.3,2,3,1,2,3,4,10,0,19/20
Martín Montoya,es ESP,DFMF,Brighton,28,1991,21.1,57,29,31,20,6,30,56,53.6,26,19,5,14,24,81,40,0,19/20
Simon Moore,eng ENG,GK,Sheffield Utd,29,1990,2,1,0,1,0,0,1,1,100,0,0,0,0,0,1,0,1,19/20
Aaron Mooy,au AUS,MFFW,Brighton,28,1990,23.2,37,24,9,18,10,6,40,15,34,36,7,29,23,60,32,1,19/20
Wesley Moraes,br BRA,FW,Aston Villa,22,1996,19.8,15,8,3,8,4,0,5,0,5,10,2,8,4,19,23,0,19/20
Wes Morgan,jm JAM,DF,Leicester City,35,1984,4.8,4,1,3,1,0,0,3,0,3,5,3,2,7,11,19,0,19/20
Ravel Morrison,jm JAM,MF,Sheffield Utd,26,1993,0.1,0,0,0,0,0,0,0,,0,0,0,0,0,0,0,0,19/20
Mason Mount,eng ENG,MFFW,Chelsea,20,1999,31.9,37,17,8,19,10,9,42,21.4,33,25,3,22,16,53,18,0,19/20
Lucas Moura,br BRA,FWMF,Tottenham,26,1992,24.9,57,33,25,22,10,16,58,27.6,42,29,2,27,15,72,27,0,19/20
Lys Mousset,fr FRA,FW,Sheffield Utd,23,1996,13.8,9,5,0,5,4,3,7,42.9,4,3,0,3,4,13,2,0,19/20
João Moutinho,pt POR,MF,Wolves,32,1986,34.5,93,50,43,41,9,46,139,33.1,93,43,13,30,50,143,18,1,19/20
Glenn Murray,eng ENG,FW,Brighton,35,1983,8.9,5,2,0,3,2,2,9,22.2,7,6,2,4,1,6,12,0,19/20
Shkodran Mustafi,de GER,DF,Arsenal,27,1992,13.4,17,10,11,5,1,6,12,50,6,10,6,4,18,35,72,0,19/20
Yoshinori Mutō,jp JPN,MFFW,Newcastle Utd,27,1992,2.4,3,2,1,2,0,1,2,50,1,0,0,0,0,3,0,0,19/20
Georges-Kévin N'Koudou,cm CMR,FW,Tottenham,24,1995,0,0,0,0,0,0,0,1,0,1,0,0,0,0,0,0,0,19/20
Marvelous Nakamba,zw ZIM,MF,Aston Villa,25,1994,20.4,55,28,28,20,7,24,67,35.8,43,50,11,39,39,94,38,3,19/20
Wilfred Ndidi,ng NGA,MF,Leicester City,22,1996,29.7,128,67,56,61,11,45,91,49.5,46,52,6,46,80,208,69,3,19/20
Tanguy Ndombele,fr FRA,MF,Tottenham,22,1996,11.2,24,16,10,13,1,9,22,40.9,13,20,3,17,14,38,7,0,19/20
Reiss Nelson,eng ENG,FW,Arsenal,19,1999,7,11,8,5,4,2,7,17,41.2,10,13,2,11,3,14,3,0,19/20
Pedro Neto,pt POR,FWMF,Wolves,19,2000,10.4,9,4,3,6,0,4,15,26.7,11,2,0,2,6,15,4,0,19/20
Rúben Neves,pt POR,MF,Wolves,22,1997,34,62,33,27,32,3,34,86,39.5,52,38,9,29,56,118,34,1,19/20
Jeremy Ngakia,eng ENG,DF,West Ham,18,2000,4.9,15,7,10,5,0,9,21,42.9,12,6,1,5,7,22,16,0,19/20
Oumar Niasse,sn SEN,FW,Everton,29,1990,0.2,4,0,0,2,2,0,0,,0,0,0,0,1,5,0,0,19/20
Eddie Nketiah,eng ENG,FW,Arsenal,20,1999,7,7,5,3,4,0,2,6,33.3,4,9,0,9,2,9,5,0,19/20
Mark Noble,eng ENG,MF,West Ham,32,1987,29.7,52,30,19,28,5,22,64,34.4,42,20,6,14,20,72,10,1,19/20
Oliver Norwood,nir NIR,MF,Sheffield Utd,28,1991,34.3,66,37,35,24,7,28,97,28.9,69,34,12,22,47,113,40,1,19/20
Ørjan Nyland,no NOR,GK,Aston Villa,28,1990,6,0,0,0,0,0,0,0,,0,0,0,0,0,0,1,1,19/20
Jack O'Connell,eng ENG,DF,Sheffield Utd,25,1994,32.4,23,14,15,6,2,10,20,50,10,38,17,21,42,65,154,1,19/20
Michael Obafemi,ie IRL,FW,Southampton,19,2000,7.4,7,3,1,3,3,2,14,14.3,12,3,0,3,6,13,0,0,19/20
Angelo Ogbonna,it ITA,DF,West Ham,31,1988,31,38,24,20,14,4,18,32,56.3,14,50,32,18,27,65,134,1,19/20
Divock Origi,be BEL,FW,Liverpool,24,1995,8,12,9,2,5,5,4,9,44.4,5,2,0,2,4,16,5,0,19/20
Ben Osborn,eng ENG,MFDF,Sheffield Utd,24,1994,6.6,15,10,11,3,1,3,16,18.8,13,6,1,5,6,21,7,0,19/20
Nicolás Otamendi,ar ARG,DF,Manchester City,31,1988,19.1,28,14,21,6,1,16,33,48.5,17,15,9,6,21,49,76,2,19/20
Alex Oxlade-Chamberlain,eng ENG,MFFW,Liverpool,25,1993,16.5,18,9,4,6,8,5,21,23.8,16,26,1,25,22,40,10,0,19/20
Mesut Özil,de GER,MF,Arsenal,30,1988,16,17,8,9,7,1,4,23,17.4,19,4,0,4,5,22,1,0,19/20
Emerson Palmieri,it ITA,DF,Chelsea,24,1994,11.4,23,12,8,11,4,10,15,66.7,5,13,1,12,18,41,19,0,19/20
Sokratis Papastathopoulos,gr GRE,DF,Arsenal,31,1988,18.8,25,16,17,7,1,10,21,47.6,11,30,24,6,17,42,68,1,19/20
Troy Parrott,ie IRL,FW,Tottenham,17,2002,0.1,0,0,0,0,0,0,0,,0,0,0,0,0,0,0,0,19/20
Rui Patrício,pt POR,GK,Wolves,31,1988,38,0,0,0,0,0,0,2,0,2,2,0,2,2,2,5,2,19/20
Pedro,es ESP,FWMF,Chelsea,32,1987,7.3,15,7,5,9,1,3,15,20,12,9,0,9,9,24,1,0,19/20
Nicolas Pépé,ci CIV,FW,Arsenal,24,1995,22.3,32,17,15,13,4,8,16,50,8,15,2,13,8,40,5,0,19/20
Andreas Pereira,br BRA,MFFW,Manchester Utd,23,1996,16.5,24,13,8,9,7,10,39,25.6,29,13,0,13,7,31,7,0,19/20
Ricardo Pereira,pt POR,DF,Leicester City,25,1993,28,119,68,65,36,18,53,106,50,53,38,6,32,49,168,86,0,19/20
Roberto Pereyra,ar ARG,FWMF,Watford,28,1991,18.3,20,8,11,7,2,9,28,32.1,19,21,0,21,14,34,12,1,19/20
Ayoze Pérez,es ESP,MFFW,Leicester City,26,1993,22.3,45,28,14,26,5,8,54,14.8,46,33,1,32,14,59,9,1,19/20
Jordan Pickford,eng ENG,GK,Everton,25,1994,38,0,0,0,0,0,0,4,0,4,0,0,0,3,3,12,6,19/20
Brandon Pierrick,eng ENG,MFFW,Crystal Palace,17,2001,0.2,0,0,0,0,0,0,0,,0,0,0,0,0,0,1,0,19/20
Erik Pieters,nl NED,DFMF,Burnley,30,1988,20.9,54,32,18,29,7,28,69,40.6,41,30,4,26,28,82,60,1,19/20
Daniel Podence,pt POR,FWMF,Wolves,23,1995,3.2,3,3,2,0,1,0,2,0,2,4,1,3,2,5,1,0,19/20
Paul Pogba,fr FRA,MF,Manchester Utd,26,1993,13.4,20,9,8,8,4,8,16,50,8,12,4,8,7,27,10,2,19/20
Nick Pope,eng ENG,GK,Burnley,27,1992,38,1,1,1,0,0,1,2,50,1,0,0,0,3,4,15,3,19/20
Dennis Praet,be BEL,MF,Leicester City,25,1994,12.6,33,18,8,21,4,9,29,31,20,19,1,18,17,50,12,0,19/20
Sebastian Prödl,at AUT,DF,Watford,32,1987,0.6,0,0,0,0,0,0,0,,0,0,0,0,0,0,4,0,19/20
Davy Pröpper,nl NED,MF,Brighton,27,1991,31.4,64,35,28,28,8,23,74,31.1,51,27,8,19,38,102,36,4,19/20
Teemu Pukki,fi FIN,FW,Norwich City,29,1990,32.1,12,6,3,5,4,1,23,4.3,22,13,0,13,6,18,7,0,19/20
Christian Pulisic,us USA,FW,Chelsea,20,1998,19.1,23,11,13,4,6,7,24,29.2,17,15,0,15,6,29,11,0,19/20
Ignacio Pussetto,ar ARG,FWMF,Watford,23,1995,0.8,7,4,4,2,1,3,8,37.5,5,2,1,1,3,10,4,0,19/20
Domingos Quina,pt POR,MFFW,Watford,19,1999,0.2,2,0,1,1,0,1,2,50,1,3,0,3,0,2,0,0,19/20
Aaron Ramsdale,eng ENG,GK,Bournemouth,21,1998,37,4,3,4,0,0,3,3,100,0,0,0,0,0,4,25,1,19/20
Darren Randolph,ie IRL,GK,West Ham,32,1987,2,0,0,0,0,0,0,0,,0,0,0,0,0,0,2,0,19/20
Marcus Rashford,eng ENG,FW,Manchester Utd,21,1997,29.4,13,9,1,6,6,9,23,39.1,14,23,0,23,10,23,19,0,19/20
Nathan Redmond,eng ENG,MFFW,Southampton,25,1994,30.7,49,29,17,23,9,21,57,36.8,36,39,2,37,16,65,16,0,19/20
Pepe Reina,es ESP,GK,Aston Villa,36,1982,12,0,0,0,0,0,0,2,0,2,0,0,0,0,0,9,1,19/20
Declan Rice,eng ENG,MF,West Ham,20,1999,38,116,60,64,48,4,47,98,48,51,41,9,32,77,193,55,0,19/20
Richarlison,br BRA,FWMF,Everton,22,1997,34.1,70,47,28,28,14,27,56,48.2,29,34,4,30,12,82,42,0,19/20
Diego Rico,es ESP,DF,Bournemouth,26,1993,25.9,61,39,32,24,5,29,59,49.2,30,31,7,24,84,145,91,0,19/20
Jaïro Riedewald,nl NED,DFMF,Crystal Palace,22,1996,8.5,14,10,4,10,0,7,11,63.6,4,7,2,5,17,31,23,1,19/20
Matt Ritchie,sct SCO,DFMF,Newcastle Utd,29,1989,14.6,22,15,9,10,3,3,15,20,12,20,5,15,14,36,31,1,19/20
Roberto,es ESP,GK,West Ham,33,1986,7.6,0,0,0,0,0,0,0,,0,0,0,0,0,0,2,2,19/20
Patrick Roberts,eng ENG,FWMF,Norwich City,22,1997,0.3,0,0,0,0,0,0,0,,0,0,0,0,0,0,0,0,19/20
Andrew Robertson,sct SCO,DF,Liverpool,25,1994,34.6,54,31,17,25,12,27,61,44.3,34,29,7,22,38,92,72,1,19/20
Callum Robinson,ie IRL,FWMF,Sheffield Utd,24,1995,7.5,6,3,2,2,2,2,7,28.6,5,3,0,3,7,13,3,0,19/20
Jack Robinson,eng ENG,DF,Sheffield Utd,25,1993,5.6,10,5,5,5,0,1,6,16.7,5,12,5,7,8,18,24,0,19/20
Rodri,es ESP,MF,Manchester City,23,1996,27.6,50,30,17,25,8,23,63,36.5,40,19,5,14,26,76,35,0,19/20
Jay Rodriguez,eng ENG,FW,Burnley,30,1989,22.4,29,19,4,13,12,8,33,24.2,25,33,6,27,5,34,12,0,19/20
Jack Rodwell,eng ENG,MF,Sheffield Utd,28,1991,0.2,0,0,0,0,0,0,0,,0,0,0,0,0,0,1,0,19/20
Marcos Rojo,ar ARG,DF,Manchester Utd,29,1990,1.4,3,1,2,1,0,1,2,50,1,2,1,1,0,3,6,0,19/20
Oriol Romeu,es ESP,MF,Southampton,27,1991,20.7,55,35,23,30,2,27,75,36,48,35,13,22,34,89,32,0,19/20
Danny Rose,eng ENG,DF,Tottenham,29,1990,9.9,18,11,6,10,2,9,20,45,11,14,6,8,8,26,34,2,19/20
Danny Rose,eng ENG,DF,Newcastle Utd,29,1990,9.6,21,12,11,8,2,12,21,57.1,9,11,4,7,10,31,14,1,19/20
Antonio Rüdiger,de GER,DF,Chelsea,26,1993,19,28,18,19,7,2,16,25,64,9,15,9,6,16,44,59,1,19/20
Lukas Rupp,de GER,FWMF,Norwich City,28,1991,7.7,15,9,7,5,3,5,17,29.4,12,11,0,11,15,30,4,0,19/20
Mathew Ryan,au AUS,GK,Brighton,27,1992,38,1,1,1,0,0,1,4,25,3,0,0,0,2,3,13,2,19/20
Allan Saint-Maximin,fr FRA,MFFW,Newcastle Utd,22,1997,20.7,13,8,7,4,2,4,18,22.2,14,5,2,3,9,22,6,0,19/20
Romain Saïss,ma MAR,DF,Wolves,29,1990,30.1,55,38,37,15,3,32,46,69.6,14,31,16,15,55,110,127,3,19/20
Bukayo Saka,eng ENG,DFFW,Arsenal,17,2001,19.5,36,21,21,8,7,19,37,51.4,18,12,3,9,12,48,19,0,19/20
Mamadou Sakho,fr FRA,DF,Crystal Palace,29,1990,10.3,7,5,5,1,1,2,5,40,3,12,5,7,20,27,46,2,19/20
Mohamed Salah,eg EGY,FW,Liverpool,27,1992,32,16,6,1,4,11,5,22,22.7,17,3,1,2,8,24,2,1,19/20
Mbwana Samatta,tz TAN,FW,Aston Villa,26,1992,10.5,6,4,0,3,3,1,8,12.5,7,7,0,7,1,7,6,0,19/20
Carlos Sánchez,co COL,MF,West Ham,33,1986,1.3,1,0,0,1,0,1,1,100,0,1,0,1,2,3,1,0,19/20
Davinson Sánchez,co COL,DF,Tottenham,23,1996,27,44,27,32,12,0,22,44,50,22,40,28,12,34,78,128,5,19/20
Leroy Sané,de GER,FW,Manchester City,23,1996,0.1,0,0,0,0,0,0,0,,0,0,0,0,0,0,0,0,19/20
Ismaila Sarr,sn SEN,FWMF,Watford,21,1998,22.5,11,10,5,2,4,5,23,21.7,18,9,1,8,18,29,10,0,19/20
Fabian Schär,ch SUI,DFMF,Newcastle Utd,27,1991,18.6,39,21,25,14,0,19,40,47.5,21,35,18,17,47,86,74,2,19/20
Ezequiel Schelotto,it ITA,DF,Brighton,30,1989,4,4,3,1,2,1,2,8,25,6,3,0,3,7,11,14,0,19/20
Jeffrey Schlupp,gh GHA,FWMF,Crystal Palace,26,1992,11.5,18,9,10,7,1,6,16,37.5,10,11,3,8,13,31,15,0,19/20
Kasper Schmeichel,dk DEN,GK,Leicester City,32,1986,38,1,1,1,0,0,1,2,50,1,0,0,0,1,2,4,2,19/20
Morgan Schneiderlin,fr FRA,MF,Everton,29,1989,11.1,31,22,13,16,2,8,24,33.3,16,13,3,10,21,52,20,1,19/20
Ryan Sessegnon,eng ENG,DFFW,Tottenham,19,2000,3.8,6,4,2,4,0,3,6,50,3,0,0,0,3,9,12,0,19/20
Xherdan Shaqiri,ch SUI,FWMF,Liverpool,27,1991,2.1,1,0,0,1,0,0,1,0,1,0,0,0,0,1,0,0,19/20
Billy Sharp,eng ENG,FW,Sheffield Utd,33,1986,11.7,6,5,2,1,3,1,6,16.7,5,2,0,2,1,7,2,0,19/20
Luke Shaw,eng ENG,DF,Manchester Utd,24,1995,19.3,34,18,19,11,4,19,33,57.6,14,26,6,20,24,58,56,1,19/20
Jonjo Shelvey,eng ENG,MF,Newcastle Utd,27,1992,23.5,29,19,17,12,0,11,42,26.2,31,14,5,9,23,52,38,0,19/20
Djibril Sidibé,fr FRA,DFMF,Everton,27,1992,20.3,83,44,48,25,10,43,72,59.7,29,19,3,16,40,123,41,0,19/20
Gylfi Sigurðsson,is ISL,MF,Everton,29,1989,28.4,50,26,15,24,11,19,70,27.1,51,30,4,26,37,87,17,1,19/20
Bernardo Silva,pt POR,FWMF,Manchester City,24,1994,22.6,36,18,8,21,7,13,44,29.5,31,25,1,24,24,60,13,0,19/20
David Silva,es ESP,MF,Manchester City,33,1986,20.3,26,14,3,15,8,10,28,35.7,18,18,3,15,13,39,5,0,19/20
Jack Simpson,eng ENG,DF,Bournemouth,22,1996,2.7,5,2,4,1,0,2,8,25,6,1,0,1,2,7,12,1,19/20
Moussa Sissoko,fr FRA,MF,Tottenham,29,1989,27.2,39,25,25,12,2,20,48,41.7,28,19,4,15,27,66,43,2,19/20
Oliver Skipp,eng ENG,MF,Tottenham,18,2000,0.9,2,2,0,2,0,1,4,25,3,3,2,1,0,2,0,0,19/20
William Smallbone,ie IRL,MF,Southampton,19,2000,4.4,10,5,2,8,0,5,10,50,5,7,1,6,1,11,2,0,19/20
Adam Smith,eng ENG,DF,Bournemouth,28,1991,22.8,47,32,29,16,2,23,50,46,27,27,6,21,25,72,64,1,19/20
Emile Smith Rowe,eng ENG,MF,Arsenal,19,2000,1.1,1,1,1,0,0,1,3,33.3,2,0,0,0,1,2,2,0,19/20
Robert Snodgrass,sct SCO,MFFW,West Ham,31,1987,16.8,29,16,17,10,2,13,44,29.5,31,12,1,11,4,33,11,0,19/20
Cédric Soares,pt POR,MFDF,Arsenal,27,1991,2.8,8,6,2,6,0,1,3,33.3,2,3,0,3,3,11,4,0,19/20
Cédric Soares,pt POR,DF,Southampton,27,1991,14.5,45,26,19,24,2,25,41,61,16,18,4,14,19,64,51,0,19/20
Dominic Solanke,eng ENG,FW,Bournemouth,21,1997,18.3,8,4,2,5,1,5,33,15.2,28,9,1,8,8,16,18,1,19/20
Tomáš Souček,cz CZE,MF,West Ham,24,1995,11.6,29,15,13,15,1,10,23,43.5,13,7,1,6,22,51,35,0,19/20
Çağlar Söyüncü,tr TUR,DF,Leicester City,23,1996,33.7,60,40,41,18,1,27,46,58.7,19,35,19,16,43,103,156,1,19/20
Dennis Srbeny,de GER,MFFW,Norwich City,25,1994,0.5,5,5,3,2,0,1,3,33.3,2,1,0,1,0,5,1,0,19/20
Jack Stacey,eng ENG,DF,Bournemouth,23,1996,17.2,21,11,9,11,1,8,22,36.4,14,27,11,16,18,39,64,1,19/20
Junior Stanislas,eng ENG,MFFW,Bournemouth,29,1989,7.9,10,7,2,3,5,3,8,37.5,5,6,0,6,4,14,6,0,19/20
Jed Steer,eng ENG,GK,Aston Villa,26,1992,0.1,0,0,0,0,0,0,0,,0,0,0,0,0,0,0,0,19/20
Dale Stephens,eng ENG,MF,Brighton,30,1989,28.1,73,44,30,37,6,25,75,33.3,50,31,11,20,58,131,42,2,19/20
Jack Stephens,eng ENG,DF,Southampton,25,1994,27.2,44,27,30,13,1,24,46,52.2,22,38,22,16,31,75,120,2,19/20
Raheem Sterling,eng ENG,FW,Manchester City,24,1994,29.5,27,15,8,10,9,6,28,21.4,22,16,2,14,15,42,4,0,19/20
Enda Stevens,ie IRL,DF,Sheffield Utd,29,1990,37.2,81,46,48,26,7,42,96,43.8,54,27,8,19,35,116,71,3,19/20
Marco Stiepermann,de GER,MF,Norwich City,28,1991,13.1,20,8,8,9,3,5,21,23.8,16,11,3,8,5,25,16,0,19/20
John Stones,eng ENG,DF,Manchester City,25,1994,12.5,16,10,8,7,1,3,5,60,2,5,3,2,9,25,32,2,19/20
Isaac Success,ng NGA,FWMF,Watford,23,1996,0.8,0,0,0,0,0,0,0,,0,0,0,0,1,1,0,0,19/20
Ki Sung-yueng,kr KOR,MF,Newcastle Utd,30,1989,1.5,1,1,0,1,0,1,3,33.3,2,1,0,1,3,4,2,0,19/20
Andrew Surman,eng ENG,MF,Bournemouth,32,1986,2.6,4,2,2,2,0,1,3,33.3,2,1,0,1,1,5,5,1,19/20
Sam Surridge,eng ENG,FWMF,Bournemouth,21,1998,0.3,0,0,0,0,0,0,0,,0,1,0,1,1,1,0,0,19/20
Japhet Tanganga,eng ENG,DF,Tottenham,20,1999,5.8,17,9,10,6,1,10,17,58.8,7,7,6,1,11,28,31,2,19/20
Matt Targett,eng ENG,DFMF,Aston Villa,23,1995,25.5,52,29,37,11,4,22,53,41.5,31,28,8,20,56,108,82,0,19/20
James Tarkowski,eng ENG,DF,Burnley,26,1992,38,66,43,47,19,0,31,54,57.4,23,63,47,16,63,129,204,4,19/20
Charlie Taylor,eng ENG,DF,Burnley,25,1993,21.6,39,24,26,9,4,19,39,48.7,20,29,9,20,29,68,78,1,19/20
Neil Taylor,wls WAL,DF,Aston Villa,30,1989,12.1,16,11,12,4,0,11,20,55,9,15,5,10,20,36,43,0,19/20
Nathan Tella,eng ENG,FW,Southampton,20,1999,0,0,0,0,0,0,0,0,,0,0,0,0,0,0,0,0,19/20
Alexander Tettey,no NOR,MFDF,Norwich City,33,1986,26,23,18,7,16,0,11,39,28.2,28,20,9,11,43,66,72,1,19/20
Jordan Thomas,eng ENG,FW,Norwich City,18,2001,0,0,0,0,0,0,0,0,,0,0,0,0,0,0,0,0,19/20
Luke Thomas,eng ENG,MFDF,Leicester City,18,2001,3,1,0,0,1,0,0,3,0,3,2,0,2,3,4,7,0,19/20
Max Thompson,eng ENG,FW,Burnley,17,2002,0,0,0,0,0,0,0,0,,0,0,0,0,0,0,0,0,19/20
Youri Tielemans,be BEL,MF,Leicester City,22,1997,31.4,52,29,17,30,5,24,74,32.4,50,43,4,39,22,74,18,0,19/20
Kieran Tierney,sct SCO,DFMF,Arsenal,22,1997,11,20,16,13,6,1,11,15,73.3,4,10,4,6,9,29,37,1,19/20
James Tomkins,eng ENG,DF,Crystal Palace,30,1989,17.6,29,17,21,8,0,18,25,72,7,17,15,2,21,50,103,0,19/20
Fikayo Tomori,eng ENG,DF,Chelsea,21,1997,14.3,29,16,21,8,0,10,15,66.7,5,13,7,6,22,51,48,2,19/20
Lucas Torreira,uy URU,MF,Arsenal,23,1996,16.8,31,16,11,15,5,16,39,41,23,24,8,16,34,65,24,0,19/20
Cenk Tosun,tr TUR,FW,Crystal Palace,28,1991,2,2,2,2,0,0,0,2,0,2,0,0,0,0,2,1,0,19/20
Cenk Tosun,tr TUR,FW,Everton,28,1991,3.2,2,0,0,0,2,0,1,0,1,1,0,1,0,2,1,0,19/20
Andros Townsend,eng ENG,FWMF,Crystal Palace,28,1991,14.4,34,21,12,17,5,15,37,40.5,22,18,0,18,15,49,10,1,19/20
Adama Traoré,es ESP,FWDF,Wolves,23,1996,28.9,33,21,6,14,13,8,23,34.8,15,19,3,16,13,46,14,2,19/20
Mark Travers,ie IRL,GK,Bournemouth,20,1999,1,0,0,0,0,0,0,0,,0,0,0,0,0,0,1,1,19/20
Trézéguet,eg EGY,FWMF,Aston Villa,24,1994,21.7,38,16,18,15,5,9,44,20.5,35,23,2,21,25,63,18,0,19/20
Leandro Trossard,be BEL,FWMF,Brighton,24,1994,22.3,22,17,7,12,3,6,38,15.8,32,16,1,15,9,31,8,0,19/20
Tom Trybull,de GER,MF,Norwich City,26,1993,12.6,39,25,15,18,6,16,60,26.7,44,20,5,15,16,55,35,0,19/20
Axel Tuanzebe,eng ENG,DF,Manchester Utd,21,1997,2.1,2,2,0,2,0,1,2,50,1,1,0,1,5,7,5,1,19/20
Yan Valery,tn TUN,DF,Southampton,20,1999,8.7,20,7,9,7,4,11,19,57.9,8,9,1,8,13,33,32,2,19/20
Jesús Vallejo,es ESP,DF,Wolves,22,1997,1.8,1,1,1,0,0,1,2,50,1,4,3,1,2,3,8,1,19/20
Virgil van Dijk,nl NED,DF,Liverpool,28,1991,38,23,12,18,5,0,6,13,46.2,7,20,15,5,40,63,166,2,19/20
Jamie Vardy,eng ENG,FW,Leicester City,32,1987,33.7,15,12,0,9,6,2,4,50,2,22,4,18,2,17,22,0,19/20
Indiana Vassilev,us USA,FWMF,Aston Villa,18,2001,0.6,0,0,0,0,0,0,0,,0,0,0,0,0,0,0,0,19/20
Jan Vertonghen,be BEL,DF,Tottenham,32,1987,18.3,40,24,25,14,1,20,31,64.5,11,18,10,8,33,73,68,0,19/20
Jannik Vestergaard,dk DEN,DF,Southampton,26,1992,16.6,19,12,14,5,0,11,28,39.3,17,15,9,6,26,45,99,2,19/20
Rúben Vinagre,pt POR,MFDF,Wolves,20,1999,7.2,23,13,15,6,2,12,15,80,3,7,2,5,11,34,22,0,19/20
Jake Vokins,eng ENG,DF,Southampton,19,2000,1,2,2,0,0,2,1,1,100,0,0,0,0,0,2,1,0,19/20
Mario Vrančić,ba BIH,MF,Norwich City,30,1989,7.1,27,16,14,11,2,16,27,59.3,11,9,0,9,10,37,4,2,19/20
Matěj Vydra,cz CZE,FW,Burnley,27,1992,9.1,4,3,0,3,1,3,6,50,3,7,3,4,1,5,6,0,19/20
Theo Walcott,eng ENG,MFFW,Everton,30,1989,14.3,13,8,6,5,2,3,15,20,12,13,0,13,8,21,1,0,19/20
Kyle Walker,eng ENG,DF,Manchester City,29,1990,26.6,28,18,12,15,1,12,29,41.4,17,15,6,9,28,56,42,1,19/20
Kyle Walker-Peters,eng ENG,DF,Southampton,22,1997,7.8,13,8,5,6,2,6,16,37.5,10,10,3,7,14,27,21,1,19/20
Kyle Walker-Peters,eng ENG,DF,Tottenham,22,1997,2.7,8,5,8,0,0,5,9,55.6,4,4,2,2,3,11,5,1,19/20
Aaron Wan-Bissaka,eng ENG,DF,Manchester Utd,21,1997,34.1,129,80,71,50,8,64,86,74.4,22,46,13,33,66,195,83,0,19/20
Victor Wanyama,ke KEN,MF,Tottenham,28,1991,0.3,0,0,0,0,0,0,0,,0,0,0,0,0,0,0,0,19/20
Joel Ward,eng ENG,DF,Crystal Palace,29,1989,26.5,69,42,48,16,5,39,56,69.6,17,13,6,7,48,117,93,1,19/20
James Ward-Prowse,eng ENG,MFDF,Southampton,24,1994,38,92,48,39,39,14,39,94,41.5,55,48,14,34,60,152,75,1,19/20
Kelland Watts,eng ENG,DF,Newcastle Utd,19,1999,0.2,1,0,1,0,0,1,1,100,0,0,0,0,0,1,0,0,19/20
Adam Webster,eng ENG,DF,Brighton,24,1995,29.6,30,17,21,8,1,14,32,43.8,18,43,26,17,45,75,110,2,19/20
Danny Welbeck,eng ENG,FWMF,Watford,28,1990,9.1,14,6,6,5,3,3,11,27.3,8,12,1,11,5,19,7,0,19/20
Ashley Westwood,eng ENG,MF,Burnley,29,1990,35,54,33,15,32,7,17,48,35.4,31,23,11,12,32,86,32,3,19/20
Connor Wickham,eng ENG,FWMF,Crystal Palace,26,1993,1.1,1,1,1,0,0,0,0,,0,1,0,1,1,2,0,0,19/20
Georginio Wijnaldum,nl NED,MF,Liverpool,28,1990,32.6,38,20,12,21,5,10,40,25,30,18,4,14,17,55,34,3,19/20
Jetro Willems,nl NED,DF,Newcastle Utd,25,1994,16.6,37,19,29,6,2,18,39,46.2,21,20,5,15,17,54,42,1,19/20
Brandon Williams,eng ENG,DF,Manchester Utd,18,2000,11.2,21,15,11,6,4,9,29,31,20,9,4,5,16,37,27,0,19/20
Neco Williams,wls WAL,DF,Liverpool,18,2001,2.6,5,3,1,3,1,4,5,80,1,3,1,2,9,14,6,0,19/20
Willian,br BRA,FWMF,Chelsea,30,1988,28.9,45,27,14,24,7,14,43,32.6,29,15,0,15,20,65,7,0,19/20
Joe Willock,eng ENG,MFFW,Arsenal,19,1999,9.5,25,16,9,12,4,8,21,38.1,13,16,2,14,4,29,11,2,19/20
Jack Wilshere,eng ENG,MF,West Ham,27,1992,2.4,1,0,1,0,0,0,4,0,4,3,0,3,1,2,0,0,19/20
Callum Wilson,eng ENG,FW,Bournemouth,27,1992,32.3,12,9,3,6,3,2,17,11.8,15,16,2,14,4,16,16,0,19/20
Harry Wilson,wls WAL,MFFW,Bournemouth,22,1997,18.3,23,13,8,10,5,11,34,32.4,23,26,2,24,11,34,15,1,19/20
Harry Winks,eng ENG,MF,Tottenham,23,1996,24.7,40,24,18,20,2,17,54,31.5,37,27,8,19,36,76,32,1,19/20
Chris Wood,nz NZL,FW,Burnley,27,1991,27.1,7,4,2,4,1,5,15,33.3,10,15,2,13,4,11,18,0,19/20
Granit Xhaka,ch SUI,MF,Arsenal,26,1992,28.7,45,25,20,19,6,25,55,45.5,30,32,16,16,21,66,59,3,19/20
Andriy Yarmolenko,ua UKR,MFFW,West Ham,29,1989,11,13,8,5,6,2,5,20,25,15,3,1,2,6,19,4,0,19/20
DeAndre Yedlin,us USA,DF,Newcastle Utd,26,1993,10.4,18,13,10,6,2,8,16,50,8,13,7,6,10,28,20,0,19/20
Maya Yoshida,jp JPN,DF,Southampton,30,1988,6.2,8,5,4,1,3,3,7,42.9,4,6,2,4,4,12,27,1,19/20
Ashley Young,eng ENG,DF,Manchester Utd,34,1985,10.6,14,7,7,4,3,5,17,29.4,12,8,2,6,11,25,29,0,19/20
Pablo Zabaleta,ar ARG,DF,West Ham,34,1985,6.6,18,10,12,5,1,6,13,46.2,7,5,3,2,14,32,21,0,19/20
Wilfried Zaha,ci CIV,FWMF,Crystal Palace,26,1992,36.4,43,19,18,12,13,12,49,24.5,37,22,2,20,18,61,4,0,19/20
Christoph Zimmermann,de GER,DF,Norwich City,26,1993,15.9,32,21,26,6,0,21,30,70,9,22,18,4,19,51,87,2,19/20
Oleksandr Zinchenko,ua UKR,DF,Manchester City,22,1996,14.2,31,19,16,11,4,17,32,53.1,15,9,0,9,17,48,21,1,19/20
Richairo Živković,cw CUW,FW,Sheffield Utd,22,1996,1.2,2,2,0,2,0,1,2,50,1,1,0,1,0,2,0,0,19/20
Kurt Zouma,fr FRA,DF,Chelsea,24,1994,26,23,14,17,6,0,9,16,56.3,7,22,14,8,58,81,116,2,19/20
Patrick van Aanholt,nl NED,DF,Crystal Palace,27,1990,35.5,48,24,35,11,2,24,40,60,16,33,9,24,40,88,91,2,18/19
Sergio Agüero,ar ARG,FW,Manchester City,30,1988,27.3,17,9,1,10,6,5,9,55.6,4,15,1,14,9,26,3,0,18/19
Nathan Aké,nl NED,DF,Bournemouth,23,1995,37.9,66,35,42,21,3,22,35,62.9,13,51,35,16,32,98,241,0,18/19
Marc Albrighton,eng ENG,FWMF,Leicester City,28,1989,18.1,35,22,18,14,3,13,31,41.9,18,26,3,23,23,58,30,0,18/19
Toby Alderweireld,be BEL,DF,Tottenham,29,1989,32.5,37,23,25,10,2,12,22,54.5,10,41,22,19,24,61,175,0,18/19
Trent Alexander-Arnold,eng ENG,DF,Liverpool,19,1998,27.4,61,39,31,22,8,36,68,52.9,32,19,3,16,35,96,68,0,18/19
Alisson,br BRA,GK,Liverpool,25,1992,38,2,1,2,0,0,2,2,100,0,0,0,0,1,3,14,6,18/19
Dele Alli,eng ENG,MF,Tottenham,22,1996,20.3,33,19,6,14,13,5,24,20.8,19,33,5,28,19,52,20,0,18/19
Miguel Almirón,py PAR,MF,Newcastle Utd,24,1994,8.4,20,12,7,10,3,4,10,40,6,14,1,13,8,28,5,0,18/19
Marcos Alonso,es ESP,DF,Chelsea,27,1990,30.7,73,46,44,22,7,33,58,56.9,25,25,2,23,39,112,101,0,18/19
Daniel Amartey,gh GHA,DF,Leicester City,23,1994,7.1,18,12,11,6,1,10,15,66.7,5,6,4,2,17,35,28,1,18/19
Luke Amos,eng ENG,MF,Tottenham,21,1997,0,1,0,0,1,0,0,0,,0,0,0,0,0,1,0,0,18/19
Felipe Anderson,br BRA,MFFW,West Ham,25,1993,33.8,89,49,33,44,12,31,101,30.7,70,71,0,71,41,130,18,1,18/19
Florin Andone,ro ROU,FW,Brighton,25,1993,9.8,10,2,3,4,3,1,6,16.7,5,9,1,8,3,13,12,0,18/19
Michail Antonio,jm JAM,MFFW,West Ham,28,1990,23.4,23,14,12,6,5,6,12,50,6,38,3,35,18,41,26,1,18/19
Stuart Armstrong,sct SCO,MF,Southampton,26,1992,15.9,28,20,14,6,8,8,42,19,34,14,0,14,12,40,12,0,18/19
Marko Arnautović,at AUT,FW,West Ham,29,1989,22.1,9,5,4,3,2,1,7,14.3,6,4,2,2,3,12,6,0,18/19
Kepa Arrizabalaga,es ESP,GK,Chelsea,23,1994,36,1,1,1,0,0,1,2,50,1,1,0,1,0,1,4,2,18/19
Harry Arter,ie IRL,MF,Cardiff City,28,1989,22.2,62,37,27,26,9,16,46,34.8,30,33,5,28,21,83,21,2,18/19
Christian Atsu,gh GHA,MF,Newcastle Utd,26,1992,16.6,24,15,9,11,4,5,16,31.3,11,13,3,10,7,31,16,0,18/19
Pierre-Emerick Aubameyang,ga GAB,FW,Arsenal,29,1989,30.3,21,17,6,9,6,8,28,28.6,20,26,0,26,8,29,22,0,18/19
Serge Aurier,ci CIV,DF,Tottenham,25,1992,6.3,20,12,12,4,4,8,15,53.3,7,8,2,6,7,27,20,0,18/19
Charlie Austin,eng ENG,FW,Southampton,29,1989,10.9,13,7,3,6,4,6,11,54.5,5,12,2,10,2,15,13,0,18/19
Jordan Ayew,gh GHA,FW,Crystal Palace,26,1991,13.1,38,23,12,19,7,6,20,30,14,16,0,16,7,45,6,0,18/19
Floyd Ayité,tg TOG,FWMF,Fulham,29,1988,5.3,4,4,2,1,1,2,6,33.3,4,8,1,7,7,11,5,0,18/19
César Azpilicueta,es ESP,DF,Chelsea,28,1989,37.8,105,60,52,40,13,38,67,56.7,29,63,16,47,43,148,91,3,18/19
Ryan Babel,nl NED,FWMF,Fulham,31,1986,13.9,8,4,1,5,2,3,9,33.3,6,12,0,12,6,14,13,1,18/19
Juninho Bacuna,cw CUW,MFDF,Huddersfield,20,1997,15.7,46,29,22,19,5,22,54,40.7,32,21,1,20,24,70,12,1,18/19
Leandro Bacuna,cw CUW,MF,Cardiff City,26,1991,6.2,15,10,5,7,3,8,22,36.4,14,5,2,3,15,30,9,0,18/19
Eric Bailly,ci CIV,DF,Manchester Utd,24,1994,7.1,15,9,14,1,0,8,10,80,2,9,4,5,13,28,39,1,18/19
Leighton Baines,eng ENG,DF,Everton,33,1984,4.2,8,6,4,3,1,4,6,66.7,2,2,0,2,2,10,8,0,18/19
Fabián Balbuena,py PAR,DF,West Ham,26,1991,22.4,40,20,34,6,0,16,42,38.1,26,23,15,8,53,93,175,0,18/19
Leon Balogun,ng NGA,DF,Brighton,30,1988,6.6,12,6,11,1,0,8,9,88.9,1,5,3,2,17,29,32,1,18/19
Sol Bamba,ci CIV,DF,Cardiff City,33,1985,27.5,74,42,44,30,0,31,55,56.4,24,72,32,40,82,156,181,3,18/19
Phil Bardsley,sct SCO,DF,Burnley,33,1985,18.6,32,19,15,14,3,12,21,57.1,9,25,12,13,31,63,68,1,18/19
Ross Barkley,eng ENG,MF,Chelsea,24,1993,13.8,15,10,5,7,3,4,14,28.6,10,8,1,7,9,24,17,2,18/19
Ashley Barnes,eng ENG,FW,Burnley,28,1989,26.5,28,17,4,17,7,6,29,20.7,23,29,8,21,2,30,25,0,18/19
Harvey Barnes,eng ENG,MFFW,Leicester City,20,1997,11.2,10,6,5,4,1,4,6,66.7,2,7,1,6,3,13,7,0,18/19
Antonio Barreca,it ITA,DF,Newcastle Utd,23,1995,0.1,0,0,0,0,0,0,0,,0,0,0,0,0,0,0,0,18/19
Michy Batshuayi,be BEL,FW,Crystal Palace,24,1993,8.3,2,1,1,1,0,1,2,50,1,8,3,5,3,5,0,0,18/19
Jan Bednarek,pl POL,DF,Southampton,22,1996,23.9,41,25,25,16,0,21,37,56.8,16,44,27,17,71,112,171,0,18/19
Asmir Begović,ba BIH,GK,Bournemouth,31,1987,24,0,0,0,0,0,0,3,0,3,1,0,1,1,1,15,7,18/19
Héctor Bellerín,es ESP,DF,Arsenal,23,1995,17,15,12,8,4,3,6,13,46.2,7,17,5,12,20,35,37,3,18/19
Joe Bennett,eng ENG,DF,Cardiff City,28,1990,29.3,50,29,34,16,0,22,38,57.9,16,30,8,22,60,110,93,0,18/19
Ryan Bennett,eng ENG,DF,Wolves,28,1990,34,58,32,41,16,1,25,41,61,16,42,21,21,43,101,131,1,18/19
Christian Benteke,be BEL,FW,Crystal Palace,27,1990,9,5,1,0,4,1,1,4,25,3,7,2,5,0,5,14,0,18/19
Jóhann Berg Guðmundsson,is ISL,MF,Burnley,27,1990,19.5,27,11,14,10,3,16,34,47.1,18,25,4,21,33,60,34,0,18/19
Bernard,br BRA,FWMF,Everton,25,1992,23.5,49,30,19,22,8,15,55,27.3,40,37,2,35,27,76,14,1,18/19
Bernardo,br BRA,DF,Brighton,23,1995,19.5,62,43,43,13,6,31,45,68.9,14,32,13,19,34,96,82,0,18/19
Ryan Bertrand,eng ENG,DF,Southampton,28,1989,24,46,27,22,20,4,16,31,51.6,15,27,5,22,28,74,51,0,18/19
Marcus Bettinelli,eng ENG,GK,Fulham,26,1992,7,0,0,0,0,0,0,0,,0,0,0,0,0,0,5,0,18/19
Philip Billing,dk DEN,MF,Huddersfield,22,1996,24.3,73,44,26,39,8,19,42,45.2,23,57,16,41,53,126,43,0,18/19
Yves Bissouma,ml MLI,MF,Brighton,21,1996,19.7,62,30,33,27,2,20,38,52.6,18,21,5,16,33,95,29,2,18/19
Willy Boly,ci CIV,DF,Wolves,27,1991,35.2,85,52,49,34,2,34,56,60.7,22,55,32,23,72,157,177,6,18/19
Léo Bonatini,br BRA,FW,Wolves,24,1994,1.5,1,1,0,0,1,1,5,20,4,1,0,1,0,1,0,0,18/19
Gaëtan Bong,cm CMR,DF,Brighton,30,1988,20.1,16,10,7,6,3,6,10,60,4,16,6,10,25,41,57,2,18/19
Artur Boruc,pl POL,GK,Bournemouth,38,1980,12,1,0,1,0,0,1,3,33.3,2,0,0,0,0,1,1,0,18/19
Robbie Brady,ie IRL,MF,Burnley,26,1992,8,15,7,5,5,5,6,17,35.3,11,7,1,6,7,22,18,1,18/19
Miguel Britos,uy URU,DF,Watford,33,1985,2.1,4,2,4,0,0,2,4,50,2,1,1,0,3,7,11,1,18/19
David Brooks,wls WAL,MFFW,Bournemouth,21,1997,25.1,37,26,12,19,6,19,44,43.2,25,36,7,29,24,61,28,0,18/19
Bruno,es ESP,DF,Brighton,37,1980,12.6,25,16,20,3,2,14,18,77.8,4,7,2,5,11,36,30,1,18/19
Joe Bryan,eng ENG,DFMF,Fulham,24,1993,26.1,61,41,35,21,5,24,42,57.1,18,34,12,22,31,92,82,1,18/19
David Button,eng ENG,GK,Brighton,29,1989,4,0,0,0,0,0,0,0,,0,0,0,0,0,0,2,0,18/19
Willy Caballero,ar ARG,GK,Chelsea,36,1981,2,0,0,0,0,0,0,0,,0,0,0,0,0,0,1,0,18/19
Gary Cahill,eng ENG,DF,Chelsea,32,1985,0.3,0,0,0,0,0,0,0,,0,0,0,0,0,0,1,0,18/19
Tom Cairney,sct SCO,MFFW,Fulham,27,1991,24.4,37,21,9,22,6,12,16,75,4,21,5,16,10,47,13,1,18/19
Dominic Calvert-Lewin,eng ENG,FW,Everton,21,1997,19.8,13,7,3,3,7,7,15,46.7,8,16,3,13,7,20,19,0,18/19
Rafael Camacho,pt POR,DF,Liverpool,18,2000,0,1,0,1,0,0,1,1,100,0,0,0,0,0,1,0,0,18/19
Víctor Camarasa,es ESP,MF,Cardiff City,24,1994,28.5,28,15,8,15,5,6,31,19.4,25,17,2,15,33,61,28,1,18/19
Étienne Capoue,fr FRA,MF,Watford,30,1988,32.7,91,56,36,48,7,33,87,37.9,54,50,13,37,85,176,96,1,18/19
Andy Carroll,eng ENG,FW,West Ham,29,1989,5.1,4,2,1,3,0,1,4,25,3,3,2,1,1,5,8,0,18/19
Jonny Castro,es ESP,DFMF,Wolves,24,1994,30.8,79,43,42,33,4,31,60,51.7,29,45,8,37,60,139,64,2,18/19
Craig Cathcart,nir NIR,DF,Watford,29,1989,34.4,50,31,36,11,3,21,37,56.8,16,42,30,12,38,88,184,4,18/19
Ivan Cavaleiro,pt POR,FWMF,Wolves,24,1993,7.7,5,4,3,1,1,1,14,7.1,13,12,0,12,4,9,5,0,18/19
Petr Čech,cz CZE,GK,Arsenal,36,1982,6.5,1,1,1,0,0,1,1,100,0,0,0,0,0,1,5,2,18/19
Nathaniel Chalobah,eng ENG,MF,Watford,23,1994,3,3,2,1,2,0,2,7,28.6,5,2,1,1,5,8,7,0,18/19
Calum Chambers,eng ENG,MFDF,Fulham,23,1995,28.8,64,36,32,27,5,16,48,33.3,32,37,12,25,69,133,113,4,18/19
Ben Chilwell,eng ENG,DF,Leicester City,21,1996,36,55,29,34,18,3,24,55,43.6,31,37,7,30,38,93,156,0,18/19
Tahith Chong,nl NED,FW,Manchester Utd,18,1999,0.4,0,0,0,0,0,0,0,,0,1,0,1,0,0,1,0,18/19
Hamza Choudhury,eng ENG,MF,Leicester City,20,1997,6.6,24,10,13,10,1,9,15,60,6,12,3,9,15,39,13,0,18/19
Andreas Christensen,dk DEN,DF,Chelsea,22,1996,6.9,10,4,2,6,2,2,5,40,3,4,2,2,4,14,29,0,18/19
Cyrus Christie,ie IRL,DFMF,Fulham,25,1992,21.6,43,23,26,13,4,18,41,43.9,23,25,11,14,29,72,96,1,18/19
Ibrahima Cissé,gn GUI,MF,Fulham,24,1994,1,0,0,0,0,0,0,1,0,1,0,0,0,3,3,4,0,18/19
Ciaran Clark,ie IRL,DF,Newcastle Utd,28,1989,9.5,20,17,15,5,0,9,12,75,3,11,7,4,12,32,58,0,18/19
Tom Cleverley,eng ENG,MF,Watford,28,1989,5.3,17,9,11,4,2,6,22,27.3,16,4,0,4,5,22,11,0,18/19
Nathaniel Clyne,eng ENG,DF,Bournemouth,27,1991,12.7,33,18,16,14,3,11,23,47.8,12,13,3,10,16,49,33,1,18/19
Nathaniel Clyne,eng ENG,DF,Liverpool,27,1991,1.2,4,3,2,2,0,2,4,50,2,1,0,1,2,6,1,0,18/19
Conor Coady,eng ENG,DF,Wolves,25,1993,38,31,19,26,5,0,17,32,53.1,15,35,27,8,30,61,133,3,18/19
Joel Coleman,eng ENG,GK,Huddersfield,22,1995,1,0,0,0,0,0,0,0,,0,0,0,0,0,0,0,0,18/19
Séamus Coleman,ie IRL,DF,Everton,29,1988,28.4,44,25,23,18,3,19,30,63.3,11,14,5,9,26,70,86,0,18/19
Lewis Cook,eng ENG,MF,Bournemouth,21,1997,8,13,6,6,7,0,8,19,42.1,11,8,2,6,8,21,7,1,18/19
Steve Cook,eng ENG,DF,Bournemouth,27,1991,31,36,19,31,5,0,20,27,74.1,7,36,21,15,50,86,202,1,18/19
Jack Cork,eng ENG,MF,Burnley,29,1989,36.8,51,27,12,34,5,18,46,39.1,28,39,16,23,29,80,82,2,18/19
Hélder Costa,ao ANG,FWMF,Wolves,24,1994,14.9,18,14,7,7,4,7,23,30.4,16,15,0,15,9,27,6,0,18/19
Aaron Cresswell,eng ENG,DF,West Ham,28,1989,17.7,29,16,14,11,4,13,25,52,12,28,7,21,23,52,58,0,18/19
Peter Crouch,eng ENG,FW,Burnley,37,1981,1,1,1,0,1,0,1,1,100,0,0,0,0,0,1,2,0,18/19
Greg Cunningham,ie IRL,DF,Cardiff City,27,1991,7,18,7,11,4,3,9,16,56.3,7,9,3,6,17,35,16,1,18/19
Diogo Dalot,pt POR,DFFW,Manchester Utd,19,1999,11.3,24,12,8,14,2,14,19,73.7,5,15,2,13,10,34,35,1,18/19
Matty Daly,eng ENG,MF,Huddersfield,17,2001,0.8,0,0,0,0,0,0,0,,0,0,0,0,0,0,0,0,18/19
Loïc Damour,fr FRA,MF,Cardiff City,27,1991,0.3,0,0,0,0,0,0,1,0,1,0,0,0,0,0,0,0,18/19
Charlie Daniels,eng ENG,DF,Bournemouth,31,1986,17.6,25,15,18,6,1,13,22,59.1,9,14,4,10,20,45,56,2,18/19
Danilo,br BRA,DF,Manchester City,27,1991,9,20,16,6,12,2,12,17,70.6,5,5,0,5,15,35,22,1,18/19
Scott Dann,eng ENG,DF,Crystal Palace,31,1987,7.4,6,2,5,1,0,3,7,42.9,4,16,12,4,5,11,46,0,18/19
Matteo Darmian,it ITA,DF,Manchester Utd,28,1989,4.9,14,8,10,4,0,4,11,36.4,7,9,0,9,7,21,20,0,18/19
Ben Davies,wls WAL,DF,Tottenham,25,1993,20.5,56,30,39,13,4,38,54,70.4,16,23,10,13,23,79,68,1,18/19
Tom Davies,eng ENG,MF,Everton,20,1998,10.9,27,17,9,17,1,7,23,30.4,16,15,1,14,16,43,9,1,18/19
Steven Davis,nir NIR,MF,Southampton,33,1985,1.1,2,2,0,2,0,0,0,,0,2,0,2,1,3,5,0,18/19
Kevin De Bruyne,be BEL,MF,Manchester City,27,1991,10.8,22,15,6,12,4,7,21,33.3,14,13,1,12,3,25,2,1,18/19
Troy Deeney,eng ENG,FW,Watford,30,1988,28.3,24,14,8,10,6,7,32,21.9,25,22,4,18,7,31,29,0,18/19
Jermain Defoe,eng ENG,FW,Bournemouth,35,1982,0.3,0,0,0,0,0,0,0,,0,0,0,0,0,0,0,0,18/19
Steven Defour,be BEL,MF,Burnley,30,1988,5,8,4,2,4,2,3,14,21.4,11,11,3,8,8,16,7,0,18/19
Fabian Delph,eng ENG,DF,Manchester City,28,1989,8.1,23,14,11,7,5,12,23,52.2,11,3,0,3,13,36,19,1,18/19
Mousa Dembélé,be BEL,MF,Tottenham,31,1987,5.7,13,9,6,6,1,4,7,57.1,3,4,1,3,7,20,5,2,18/19
Leander Dendoncker,be BEL,MF,Wolves,23,1995,16.3,53,26,25,25,3,16,47,34,31,35,6,29,23,76,34,1,18/19
Laurent Depoitre,be BEL,FW,Huddersfield,29,1988,11.9,6,4,2,3,1,0,3,0,3,9,0,9,2,8,8,0,18/19
Gerard Deulofeu,es ESP,FWMF,Watford,24,1994,23,11,6,5,3,3,4,26,15.4,22,16,0,16,14,25,3,0,18/19
Fousseni Diabaté,ml MLI,FW,Leicester City,22,1995,0.6,2,0,2,0,0,0,1,0,1,2,0,2,0,2,0,0,18/19
Adama Diakhaby,fr FRA,FWMF,Huddersfield,22,1996,6.1,6,3,4,1,1,3,11,27.3,8,7,0,7,1,7,2,0,18/19
Mohamed Diamé,sn SEN,MF,Newcastle Utd,31,1987,24.1,76,46,35,36,5,16,54,29.6,38,42,9,33,30,106,39,1,18/19
Grady Diangana,eng ENG,MFFW,West Ham,20,1998,6.8,20,9,8,8,4,5,14,35.7,9,11,0,11,1,21,4,0,18/19
Eric Dier,eng ENG,MFDF,Tottenham,24,1994,16.7,26,16,7,15,4,19,47,40.4,28,27,12,15,21,47,46,1,18/19
Lucas Digne,fr FRA,DF,Everton,25,1993,32.9,71,46,45,18,8,28,45,62.2,17,43,9,34,60,131,116,0,18/19
Issa Diop,fr FRA,DF,West Ham,21,1997,33,68,38,47,21,0,37,57,64.9,20,58,36,22,64,132,161,4,18/19
Matt Doherty,ie IRL,DFMF,Wolves,26,1992,34.9,67,42,48,15,4,35,58,60.3,23,49,7,42,60,127,107,2,18/19
Abdoulaye Doucouré,ml MLI,MF,Watford,25,1993,34,71,38,27,32,12,19,57,33.3,38,31,8,23,34,105,55,5,18/19
Luke Dreher,eng ENG,FW,Crystal Palace,19,1998,0,0,0,0,0,0,0,0,,0,0,0,0,0,0,0,0,18/19
Martin Dúbravka,sk SVK,GK,Newcastle Utd,29,1989,38,2,0,2,0,0,1,3,33.3,2,0,0,0,0,2,20,5,18/19
Shane Duffy,ie IRL,DF,Brighton,26,1992,34.3,35,20,23,7,5,14,25,56,11,57,47,10,36,71,244,3,18/19
Demeaco Duhaney,eng ENG,DF,Huddersfield,19,1998,0.5,1,0,1,0,0,1,3,33.3,2,2,0,2,1,2,1,0,18/19
Paul Dummett,wls WAL,DF,Newcastle Utd,26,1991,22.1,34,22,24,9,1,19,32,59.4,13,25,11,14,37,71,133,0,18/19
Lewis Dunk,eng ENG,DF,Brighton,26,1991,35,42,26,31,10,1,17,39,43.6,22,49,38,11,46,88,196,5,18/19
Erik Durm,de GER,DF,Huddersfield,26,1992,22.8,35,22,24,8,3,14,33,42.4,19,26,6,20,41,76,42,0,18/19
Bruno Ecuele Manga,ga GAB,DF,Cardiff City,30,1988,37.5,69,36,48,16,5,29,58,50,29,62,28,34,81,150,179,4,18/19
Ederson,br BRA,GK,Manchester City,24,1993,38,3,3,2,1,0,3,3,100,0,0,0,0,1,4,12,2,18/19
Harvey Elliott,eng ENG,MF,Fulham,15,2003,0.2,0,0,0,0,0,0,0,,0,1,0,1,0,0,0,0,18/19
Mohamed Elneny,eg EGY,MF,Arsenal,26,1992,4.2,13,4,9,1,3,1,2,50,1,7,4,3,2,15,8,0,18/19
Mohamed Elyounoussi,no NOR,MF,Southampton,23,1994,8.8,16,12,7,6,3,6,19,31.6,13,11,1,10,6,22,5,0,18/19
Christian Eriksen,dk DEN,MF,Tottenham,26,1992,30.8,41,25,8,20,13,17,59,28.8,42,26,3,23,15,56,13,0,18/19
Neil Etheridge,ph PHI,GK,Cardiff City,28,1990,38,1,1,1,0,0,1,2,50,1,0,0,0,7,8,19,1,18/19
Jonny Evans,nir NIR,DF,Leicester City,30,1988,22.2,24,13,20,4,0,13,18,72.2,5,28,10,18,33,57,152,3,18/19
Łukasz Fabiański,pl POL,GK,West Ham,33,1985,38,1,0,1,0,0,1,3,33.3,2,0,0,0,1,2,10,1,18/19
Fabinho,br BRA,MF,Liverpool,24,1993,22.4,59,31,17,38,4,24,59,40.7,35,34,6,28,28,87,27,2,18/19
Cesc Fàbregas,es ESP,MF,Chelsea,31,1987,2,6,4,4,2,0,1,5,20,4,2,1,1,1,7,0,0,18/19
Fabricio,es ESP,GK,Fulham,30,1987,2,1,1,1,0,0,0,0,,0,0,0,0,0,1,3,2,18/19
Marouane Fellaini,be BEL,MF,Manchester Utd,30,1987,8.4,21,13,11,9,1,9,17,52.9,8,9,5,4,4,25,34,1,18/19
Kiko Femenía,es ESP,DF,Watford,27,1991,22.8,48,30,34,12,2,24,51,47.1,27,24,6,18,36,84,68,0,18/19
Federico Fernández,ar ARG,DF,Newcastle Utd,29,1989,16.5,16,12,12,4,0,10,18,55.6,8,19,12,7,25,41,106,1,18/19
Fernandinho,br BRA,MF,Manchester City,33,1985,26.4,57,43,19,30,8,26,47,55.3,21,28,4,24,41,98,70,0,18/19
Roberto Firmino,br BRA,FWMF,Liverpool,26,1991,29,30,20,5,16,9,7,34,20.6,27,35,1,34,6,36,16,0,18/19
Phil Foden,eng ENG,MF,Manchester City,18,2000,3.7,7,6,1,3,3,2,9,22.2,7,1,0,1,4,11,1,0,18/19
Fraser Forster,eng ENG,GK,Southampton,30,1988,1,0,0,0,0,0,0,0,,0,0,0,0,0,0,1,0,18/19
Ben Foster,eng ENG,GK,Watford,35,1983,38,2,2,2,0,0,2,6,33.3,4,0,0,0,2,4,34,3,18/19
Timothy Fosu-Mensah,nl NED,DF,Fulham,20,1998,8.8,18,7,12,6,0,8,13,61.5,5,11,5,6,12,30,30,1,18/19
Juan Foyth,ar ARG,DF,Tottenham,20,1998,9.9,31,17,20,11,0,14,19,73.7,5,12,5,7,10,41,50,1,18/19
Simon Francis,eng ENG,DF,Bournemouth,33,1985,13.7,25,14,19,5,1,12,24,50,12,15,7,8,19,44,73,1,18/19
Ryan Fraser,sct SCO,MFFW,Bournemouth,24,1994,35.2,19,11,9,8,2,10,32,31.3,22,23,6,17,22,41,33,0,18/19
Fred,br BRA,MF,Manchester Utd,25,1993,11.6,29,17,12,16,1,15,33,45.5,18,26,2,24,16,45,14,2,18/19
Ryan Fredericks,eng ENG,DF,West Ham,25,1992,12.1,38,23,33,5,0,21,32,65.6,11,15,5,10,13,51,49,1,18/19
Christian Fuchs,at AUT,DF,Leicester City,32,1986,2.3,4,3,0,4,0,1,2,50,1,0,0,0,4,8,8,0,18/19
Manolo Gabbiadini,it ITA,FWMF,Southampton,26,1991,5.3,6,2,1,4,1,1,2,50,1,5,0,5,3,9,6,0,18/19
Sam Gallagher,eng ENG,FW,Southampton,22,1995,0.4,0,0,0,0,0,0,0,,0,1,0,1,0,0,1,0,18/19
Idrissa Gana Gueye,sn SEN,MF,Everton,28,1989,31.4,142,89,70,63,9,38,76,50,38,52,8,44,74,216,48,1,18/19
James Garner,eng ENG,MF,Manchester Utd,17,2001,0,0,0,0,0,0,0,0,,0,0,0,0,0,0,0,0,18/19
Paulo Gazzaniga,ar ARG,GK,Tottenham,26,1992,3,0,0,0,0,0,0,0,,0,0,0,0,0,0,1,0,18/19
David de Gea,es ESP,GK,Manchester Utd,27,1990,38,0,0,0,0,0,0,2,0,2,1,0,1,0,0,11,4,18/19
Rachid Ghezzal,dz ALG,FWMF,Leicester City,26,1992,8.3,14,5,3,7,4,3,18,16.7,15,10,1,9,7,21,4,1,18/19
Morgan Gibbs-White,eng ENG,MFFW,Wolves,18,2000,7.4,6,3,2,4,0,1,4,25,3,6,0,6,1,7,0,0,18/19
Ben Gibson,eng ENG,DF,Burnley,25,1993,0.7,1,1,1,0,0,0,0,,0,1,1,0,0,1,2,0,18/19
Olivier Giroud,fr FRA,FW,Chelsea,31,1986,9.4,3,2,0,1,2,1,4,25,3,6,1,5,3,6,7,0,18/19
André Gomes,pt POR,MF,Everton,25,1993,22,39,23,12,24,3,13,59,22,46,27,4,23,20,59,18,0,18/19
Angel Gomes,eng ENG,MFFW,Manchester Utd,17,2000,0.3,1,0,0,0,1,0,0,,0,0,0,0,0,1,0,0,18/19
Joe Gomez,eng ENG,DF,Liverpool,21,1997,11.8,18,11,10,7,1,9,15,60,6,10,5,5,14,32,42,0,18/19
Jon Gorenc Stanković,si SVN,MFDF,Huddersfield,22,1996,7.9,26,18,18,7,1,14,26,53.8,12,16,9,7,9,35,20,1,18/19
Dan Gosling,eng ENG,MF,Bournemouth,28,1990,19.3,57,23,27,21,9,28,53,52.8,25,33,11,22,20,77,46,1,18/19
Karlan Grant,eng ENG,FW,Huddersfield,20,1997,9.7,5,2,1,2,2,1,3,33.3,2,8,0,8,2,7,1,1,18/19
Andre Gray,jm JAM,FW,Watford,27,1991,15.2,3,1,0,2,1,1,6,16.7,5,3,1,2,2,5,6,0,18/19
Demarai Gray,eng ENG,FWMF,Leicester City,22,1996,22.1,25,12,7,14,4,6,16,37.5,10,19,0,19,9,34,15,0,18/19
Mason Greenwood,eng ENG,FW,Manchester Utd,16,2001,1.3,3,3,2,0,1,2,3,66.7,1,2,0,2,0,3,1,0,18/19
Pascal Groß,de GER,MFFW,Brighton,27,1991,20.7,27,12,12,12,3,11,36,30.6,25,20,8,12,13,40,23,0,18/19
Vicente Guaita,es ESP,GK,Crystal Palace,31,1987,19.5,0,0,0,0,0,0,0,,0,0,0,0,0,0,5,2,18/19
Mattéo Guendouzi,fr FRA,MF,Arsenal,19,1999,23.9,44,26,18,23,3,17,47,36.2,30,28,5,23,30,74,24,3,18/19
İlkay Gündoğan,de GER,MF,Manchester City,27,1990,23.7,19,12,4,12,3,6,31,19.4,25,12,3,9,28,47,19,1,18/19
Angus Gunn,sct SCO,GK,Southampton,22,1996,12,0,0,0,0,0,0,0,,0,0,0,0,0,0,8,3,18/19
Aron Gunnarsson,is ISL,MF,Cardiff City,29,1989,25.2,51,29,23,25,3,23,84,27.4,61,40,12,28,38,89,55,1,18/19
Florent Hadergjonaj,xk KVX,DFMF,Huddersfield,24,1994,20.5,30,17,10,18,2,13,37,35.1,24,21,7,14,21,51,37,1,18/19
Ben Hamer,eng ENG,GK,Huddersfield,30,1987,6.1,0,0,0,0,0,0,3,0,3,0,0,0,1,1,3,2,18/19
Kadeem Harris,eng ENG,MF,Cardiff City,25,1993,4.2,12,5,6,4,2,7,8,87.5,1,3,0,3,3,15,5,0,18/19
Joe Hart,eng ENG,GK,Burnley,31,1987,19,0,0,0,0,0,0,1,0,1,0,0,0,0,0,11,3,18/19
Isaac Hayden,eng ENG,MF,Newcastle Utd,23,1995,20.7,73,43,19,45,9,23,41,56.1,18,32,4,28,40,113,30,0,18/19
Eden Hazard,be BEL,FW,Chelsea,27,1991,32.5,14,9,2,1,11,5,17,29.4,12,10,0,10,13,27,6,1,18/19
Rhys Healey,wls WAL,FW,Cardiff City,23,1994,0.6,1,0,0,1,0,0,1,0,1,0,0,0,0,1,0,0,18/19
Tom Heaton,eng ENG,GK,Burnley,32,1986,19,0,0,0,0,0,0,2,0,2,0,0,0,0,0,8,2,18/19
Jordan Henderson,eng ENG,MF,Liverpool,28,1990,22.1,46,36,20,22,4,16,39,41,23,27,3,24,30,76,17,0,18/19
Jeff Hendrick,ie IRL,MFFW,Burnley,26,1992,22.9,24,12,13,7,4,9,32,28.1,23,20,5,15,12,36,31,0,18/19
Wayne Hennessey,wls WAL,GK,Crystal Palace,31,1987,17.5,0,0,0,0,0,0,2,0,2,0,0,0,0,0,5,1,18/19
Javier Hernández,mx MEX,FW,West Ham,30,1988,14.8,3,0,0,3,0,0,6,0,6,8,1,7,1,4,8,0,18/19
Ander Herrera,es ESP,MF,Manchester Utd,28,1989,15.6,54,28,24,22,8,21,61,34.4,40,38,6,32,37,91,25,1,18/19
Son Heung-min,kr KOR,FWMF,Tottenham,26,1992,22.7,23,12,7,12,4,10,34,29.4,24,26,2,24,8,31,4,1,18/19
Gonzalo Higuaín,ar ARG,FW,Chelsea,30,1987,12.1,10,7,2,4,4,2,11,18.2,9,4,0,4,1,11,5,0,18/19
Wesley Hoedt,nl NED,DF,Southampton,24,1994,13,28,12,23,5,0,17,26,65.4,9,20,13,7,23,51,79,2,18/19
Jonathan Hogg,eng ENG,MF,Huddersfield,29,1988,26.3,78,41,18,51,9,27,69,39.1,42,46,7,39,73,151,19,1,18/19
Junior Hoilett,ca CAN,MFFW,Cardiff City,28,1990,23.8,40,27,26,11,3,15,53,28.3,38,34,0,34,32,72,30,0,18/19
Rob Holding,eng ENG,DF,Arsenal,22,1995,9,11,7,9,2,0,2,8,25,6,9,7,2,12,23,40,0,18/19
José Holebas,gr GRE,DF,Watford,34,1984,26.6,68,40,44,20,4,28,53,52.8,25,27,8,19,21,89,97,0,18/19
Mason Holgate,eng ENG,DF,Everton,21,1996,4.5,5,4,4,1,0,1,1,100,0,3,2,1,3,8,32,0,18/19
Callum Hudson-Odoi,eng ENG,FW,Chelsea,17,2000,4.4,8,6,8,0,0,2,4,50,2,1,0,1,3,11,0,0,18/19
Will Hughes,eng ENG,MF,Watford,23,1995,26.9,74,43,27,35,12,25,59,42.4,34,55,6,49,25,99,30,0,18/19
Emerson Hyndman,us USA,MF,Bournemouth,22,1996,0.4,6,2,6,0,0,2,3,66.7,1,0,0,0,1,7,0,0,18/19
Pierre Højbjerg,dk DEN,MF,Southampton,22,1995,30.7,71,49,20,44,7,24,73,32.9,49,51,8,43,60,131,30,1,18/19
Jordon Ibe,eng ENG,MFDF,Bournemouth,22,1995,8.9,6,5,0,5,1,2,7,28.6,5,2,0,2,4,10,4,0,18/19
Vicente Iborra,es ESP,MF,Leicester City,30,1988,2.5,4,1,1,3,0,0,7,0,7,1,0,1,8,12,4,1,18/19
Kelechi Iheanacho,ng NGA,FWMF,Leicester City,21,1996,10.5,6,5,4,1,1,1,5,20,4,5,0,5,2,8,3,0,18/19
Danny Ings,eng ENG,FW,Southampton,26,1992,18.3,30,14,5,19,6,11,28,39.3,17,30,2,28,5,35,9,0,18/19
Alex Iwobi,ng NGA,FWMF,Arsenal,22,1996,21.9,28,14,10,16,2,6,25,24,19,21,1,20,12,40,13,1,18/19
José Izquierdo,co COL,MFFW,Brighton,26,1992,8.8,15,9,9,4,2,10,20,50,10,7,1,6,5,20,7,0,18/19
Phil Jagielka,eng ENG,DF,Everton,35,1982,3.7,7,5,3,4,0,1,4,25,3,1,0,1,2,9,14,0,18/19
Alireza Jahanbakhsh,ir IRN,FWMF,Brighton,24,1993,11.3,32,18,17,11,4,11,30,36.7,19,16,0,16,11,43,4,0,18/19
Daryl Janmaat,nl NED,DF,Watford,29,1989,16.9,36,24,23,11,2,20,29,69,9,16,6,10,33,69,71,0,18/19
Vincent Janssen,nl NED,FW,Tottenham,24,1994,0.4,2,1,0,2,0,0,0,,0,0,0,0,0,2,1,0,18/19
Carl Jenkinson,eng ENG,DF,Arsenal,26,1992,1.8,3,2,2,0,1,2,3,66.7,1,4,3,1,0,3,2,0,18/19
Gabriel Jesus,br BRA,FW,Manchester City,21,1997,11.5,10,3,5,2,3,0,5,0,5,16,2,14,3,13,4,0,18/19
Raúl Jiménez,mx MEX,FW,Wolves,27,1991,34.6,30,18,5,17,8,6,23,26.1,17,25,3,22,26,56,40,0,18/19
Stefan Johansen,no NOR,MF,Fulham,27,1991,4.6,11,3,4,7,0,5,8,62.5,3,5,0,5,3,14,6,0,18/19
Ben Johnson,eng ENG,DF,West Ham,18,2000,0.7,1,0,1,0,0,0,1,0,1,0,0,0,1,2,5,0,18/19
Tyreke Johnson,eng ENG,MF,Southampton,19,1998,0,0,0,0,0,0,0,0,,0,0,0,0,0,0,0,0,18/19
Phil Jones,eng ENG,DF,Manchester Utd,26,1992,14,19,13,12,7,0,8,13,61.5,5,16,11,5,23,42,67,3,18/19
Jorginho,it ITA,MF,Chelsea,26,1991,35.1,76,38,27,41,8,45,96,46.9,51,46,7,39,64,140,38,1,18/19
Joselu,es ESP,FW,Newcastle Utd,28,1990,6.6,14,8,4,5,5,4,9,44.4,5,5,0,5,3,17,15,0,18/19
Diogo Jota,pt POR,FWMF,Wolves,21,1996,26.2,28,16,11,11,6,10,38,26.3,28,20,1,19,13,41,11,0,18/19
Mathias Jørgensen,dk DEN,DF,Huddersfield,28,1990,23.9,49,31,27,21,1,27,46,58.7,19,29,14,15,69,118,83,0,18/19
Christian Kabasele,be BEL,DF,Watford,27,1991,17.6,25,14,20,5,0,10,23,43.5,13,21,16,5,38,63,111,0,18/19
Elias Kachunga,cd COD,FWMF,Huddersfield,26,1992,13.1,22,9,8,12,2,9,25,36,16,16,1,15,4,26,10,0,18/19
Aboubakar Kamara,mr MTN,FW,Fulham,23,1995,7.7,8,4,1,5,2,3,7,42.9,4,6,0,6,1,9,6,0,18/19
Harry Kane,eng ENG,FW,Tottenham,25,1993,26.9,10,6,2,8,0,1,14,7.1,13,16,6,10,1,11,14,0,18/19
N'Golo Kanté,fr FRA,MF,Chelsea,27,1991,34.4,75,41,21,41,13,23,67,34.3,44,63,6,57,44,119,32,1,18/19
Beram Kayal,il ISR,MF,Brighton,30,1988,10.4,28,17,16,11,1,5,21,23.8,16,17,10,7,15,43,25,0,18/19
Michael Keane,eng ENG,DF,Everton,25,1993,33,41,25,22,16,3,19,32,59.4,13,30,22,8,43,84,185,4,18/19
Neeskens Kebano,cd COD,FWMF,Fulham,26,1992,1.2,3,1,2,1,0,1,1,100,0,3,0,3,0,3,3,0,18/19
Naby Keïta,gn GUI,MFFW,Liverpool,23,1995,15.4,37,15,13,19,5,14,42,33.3,28,29,4,25,12,49,16,1,18/19
Martin Kelly,eng ENG,DF,Crystal Palace,28,1990,12.3,21,13,18,2,1,14,19,73.7,5,18,12,6,11,32,88,1,18/19
Kenedy,br BRA,MFDF,Newcastle Utd,22,1996,15,30,22,11,16,3,12,29,41.4,17,10,0,10,32,62,24,1,18/19
Jonjoe Kenny,eng ENG,DF,Everton,21,1997,8.8,21,16,16,4,1,10,18,55.6,8,13,2,11,17,38,36,1,18/19
Max Kilman,eng ENG,DF,Wolves,21,1997,0,0,0,0,0,0,0,0,,0,0,0,0,0,0,0,0,18/19
Joshua King,no NOR,FWMF,Bournemouth,26,1992,32.9,30,19,7,19,4,8,29,27.6,21,28,4,24,7,37,14,0,18/19
Anthony Knockaert,fr FRA,MFFW,Brighton,26,1991,20.4,33,21,12,15,6,13,30,43.3,17,13,0,13,29,62,11,0,18/19
Sead Kolašinac,ba BIH,DFMF,Arsenal,25,1993,21,34,21,21,7,6,20,34,58.8,14,12,3,9,20,54,28,3,18/19
Vincent Kompany,be BEL,DF,Manchester City,32,1986,13.6,16,10,11,3,2,8,9,88.9,1,11,8,3,16,32,55,0,18/19
Terence Kongolo,nl NED,DF,Huddersfield,24,1994,30.2,74,46,44,26,4,27,47,57.4,20,42,16,26,65,139,106,1,18/19
Laurent Koscielny,fr FRA,DF,Arsenal,32,1985,14.8,19,11,9,9,1,10,16,62.5,6,20,15,5,30,49,72,0,18/19
Cheikhou Kouyaté,sn SEN,MF,Crystal Palace,28,1989,21.1,59,33,23,31,5,9,33,27.3,24,29,11,18,16,75,33,0,18/19
Mateo Kovačić,hr CRO,MF,Chelsea,24,1994,19.3,45,29,23,19,3,20,46,43.5,26,19,2,17,8,53,18,1,18/19
Rajiv van La Parra,nl NED,FWMF,Huddersfield,27,1991,4.5,8,5,1,7,0,1,6,16.7,5,0,0,0,4,12,3,1,18/19
Alexandre Lacazette,fr FRA,FW,Arsenal,27,1991,27.8,35,16,6,19,10,5,28,17.9,23,27,1,26,15,50,31,0,18/19
Adam Lallana,eng ENG,MFFW,Liverpool,30,1988,5.2,16,9,6,7,3,5,12,41.7,7,10,1,9,5,21,4,0,18/19
Érik Lamela,ar ARG,MFFW,Tottenham,26,1992,10.8,17,13,6,7,4,5,14,35.7,9,14,0,14,7,24,1,0,18/19
Manuel Lanzini,ar ARG,MF,West Ham,25,1993,7.6,12,7,5,6,1,5,18,27.8,13,3,1,2,9,21,7,1,18/19
Aymeric Laporte,es ESP,DF,Manchester City,24,1994,34,42,20,27,14,1,22,34,64.7,12,16,9,7,39,81,98,2,18/19
Jamaal Lascelles,eng ENG,DF,Newcastle Utd,24,1993,30.5,32,21,25,5,2,11,14,78.6,3,43,28,15,39,71,218,3,18/19
Maxime Le Marchand,fr FRA,DF,Fulham,28,1989,25,56,36,45,11,0,23,47,48.9,24,30,16,14,54,110,129,2,18/19
Florian Lejeune,fr FRA,DF,Newcastle Utd,27,1991,11.7,25,15,17,7,1,11,24,45.8,13,16,5,11,21,46,49,0,18/19
Mario Lemina,ga GAB,MF,Southampton,24,1993,17.9,49,32,23,23,3,15,34,44.1,19,27,3,24,43,92,31,1,18/19
Aaron Lennon,eng ENG,MF,Burnley,31,1987,13.5,26,16,11,12,3,6,14,42.9,8,24,0,24,10,36,18,0,18/19
Bernd Leno,de GER,GK,Arsenal,26,1992,31.5,0,0,0,0,0,0,3,0,3,0,0,0,4,4,16,6,18/19
Jefferson Lerma,co COL,MF,Bournemouth,23,1994,27.8,45,31,20,20,5,14,54,25.9,40,35,19,16,54,99,88,1,18/19
Stephan Lichtsteiner,ch SUI,DF,Arsenal,34,1984,10.4,15,9,5,4,6,9,16,56.3,7,11,4,7,9,24,25,1,18/19
Victor Lindelöf,se SWE,DF,Manchester Utd,24,1994,28.9,40,27,28,12,0,13,23,56.5,10,21,12,9,24,64,121,3,18/19
Jesse Lingard,eng ENG,FWMF,Manchester Utd,25,1992,18.5,29,18,8,11,10,7,28,25,21,18,2,16,10,39,9,1,18/19
Fernando Llorente,es ESP,FW,Tottenham,33,1985,7.7,4,2,3,0,1,2,3,66.7,1,7,2,5,1,5,10,0,18/19
Hugo Lloris,fr FRA,GK,Tottenham,31,1986,33,1,0,1,0,0,0,2,0,2,0,0,0,0,1,13,5,18/19
Jürgen Locadia,nl NED,FWMF,Brighton,24,1993,13.7,15,10,5,8,2,3,7,42.9,4,8,0,8,9,24,13,0,18/19
Ruben Loftus-Cheek,eng ENG,MFFW,Chelsea,22,1996,11.1,18,12,7,7,4,3,12,25,9,10,4,6,11,29,5,0,18/19
Kevin Long,ie IRL,DF,Burnley,27,1990,5.7,18,10,13,5,0,7,17,41.2,10,7,5,2,7,25,35,1,18/19
Shane Long,ie IRL,FWMF,Southampton,31,1987,14.1,15,8,4,5,6,3,16,18.8,13,10,1,9,7,22,18,0,18/19
Sean Longstaff,eng ENG,MF,Newcastle Utd,20,1997,7.6,17,13,6,11,0,9,24,37.5,15,19,4,15,10,27,7,0,18/19
Ademola Lookman,ng NGA,FWMF,Everton,20,1997,6.9,15,7,7,5,3,4,6,66.7,2,10,0,10,7,22,2,0,18/19
Jonas Lössl,dk DEN,GK,Huddersfield,29,1989,30.9,0,0,0,0,0,0,1,0,1,1,0,1,2,2,12,2,18/19
Dejan Lovren,hr CRO,DF,Liverpool,29,1989,11,15,9,10,5,0,7,15,46.7,8,11,7,4,11,26,51,2,18/19
Chris Löwe,de GER,DFMF,Huddersfield,29,1989,22.9,34,18,17,15,2,12,33,36.4,21,21,3,18,23,57,56,0,18/19
Matthew Lowton,eng ENG,DF,Burnley,29,1989,19.4,56,35,21,31,4,32,60,53.3,28,29,7,22,30,86,80,1,18/19
David Luiz,br BRA,DF,Chelsea,31,1987,36,41,31,27,13,1,21,28,75,7,33,18,15,35,76,149,1,18/19
Romelu Lukaku,be BEL,FW,Manchester Utd,25,1993,23.7,8,4,0,6,2,2,10,20,8,12,1,11,2,10,19,0,18/19
James Maddison,eng ENG,MFFW,Leicester City,21,1996,31.5,48,32,20,25,3,14,58,24.1,44,20,4,16,12,60,10,1,18/19
Gary Madine,eng ENG,FWMF,Cardiff City,27,1990,0.4,1,1,0,1,0,0,0,,0,0,0,0,0,1,0,0,18/19
Harry Maguire,eng ENG,DF,Leicester City,25,1993,28.8,31,17,21,9,1,11,17,64.7,6,32,18,14,36,67,155,4,18/19
Riyad Mahrez,dz ALG,FWMF,Manchester City,27,1991,14.9,14,7,3,7,4,6,18,33.3,12,18,1,17,9,23,3,1,18/19
Ainsley Maitland-Niles,eng ENG,DF,Arsenal,20,1997,11,33,22,19,12,2,14,28,50,14,22,4,18,19,52,15,2,18/19
Sadio Mané,sn SEN,FW,Liverpool,26,1992,34.2,35,29,12,17,6,14,43,32.6,29,28,4,24,15,50,10,1,18/19
Javier Manquillo,es ESP,DF,Newcastle Utd,24,1994,12.2,27,19,14,11,2,9,14,64.3,5,9,1,8,17,44,58,0,18/19
Solly March,eng ENG,FWMF,Brighton,24,1994,27.4,56,24,27,16,13,19,45,42.2,26,34,4,30,27,83,44,0,18/19
Adrian Mariappa,jm JAM,DF,Watford,31,1986,21.4,35,22,29,6,0,16,32,50,16,23,15,8,26,61,120,2,18/19
Lazar Marković,rs SRB,MF,Fulham,24,1994,0.5,0,0,0,0,0,0,0,,0,0,0,0,0,0,2,0,18/19
Anthony Martial,fr FRA,FW,Manchester Utd,22,1995,18,9,7,2,5,2,1,11,9.1,10,12,0,12,3,12,8,0,18/19
Adam Masina,ma MAR,DF,Watford,24,1994,11.2,30,17,16,13,1,13,25,52,12,19,4,15,17,47,40,0,18/19
Arthur Masuaku,cd COD,DF,West Ham,24,1993,19.5,57,25,38,13,6,31,56,55.4,25,27,6,21,36,93,72,0,18/19
Juan Mata,es ESP,FWMF,Manchester Utd,30,1988,14.3,9,4,7,1,1,6,21,28.6,15,8,1,7,6,15,6,0,18/19
Nemanja Matić,rs SRB,MF,Manchester Utd,29,1988,27.1,50,30,27,19,4,30,59,50.8,29,39,18,21,31,81,53,4,18/19
Joël Matip,cm CMR,DF,Liverpool,26,1991,17.1,39,26,23,12,4,13,24,54.2,11,12,7,5,32,71,78,0,18/19
Konstantinos Mavropanos,gr GRE,DF,Arsenal,20,1997,1.6,1,0,0,1,0,1,1,100,0,1,1,0,7,8,5,0,18/19
Alfie Mawson,eng ENG,DF,Fulham,24,1994,12.6,11,7,7,4,0,6,10,60,4,20,17,3,19,30,64,1,18/19
Isaac Mbenza,be BEL,FWMF,Huddersfield,22,1996,11,10,9,5,5,0,2,4,50,2,4,0,4,5,15,4,0,18/19
James McArthur,sct SCO,MF,Crystal Palace,30,1987,34,84,51,38,32,14,30,78,38.5,48,64,22,42,39,123,55,0,18/19
Alex McCarthy,eng ENG,GK,Southampton,28,1989,25,0,0,0,0,0,0,0,,0,0,0,0,0,0,6,2,18/19
James McCarthy,ie IRL,MF,Everton,27,1990,0.2,2,1,1,1,0,0,0,,0,0,0,0,1,3,0,0,18/19
Kevin McDonald,sct SCO,MF,Fulham,29,1988,9.3,15,11,6,8,1,5,13,38.5,8,8,2,6,9,24,22,0,18/19
Dwight McNeil,eng ENG,MF,Burnley,18,1999,17.7,36,22,16,17,3,13,44,29.5,31,30,3,27,13,49,35,0,18/19
Scott McTominay,sct SCO,MFDF,Manchester Utd,21,1996,9.6,10,9,3,6,1,4,10,40,6,9,4,5,15,25,16,0,18/19
Ben Mee,eng ENG,DF,Burnley,28,1989,38,55,24,38,17,0,35,44,79.5,9,59,50,9,48,103,235,4,18/19
Nathaniel Mendez-Laing,eng ENG,MFFW,Cardiff City,26,1992,10.9,34,25,18,12,4,12,26,46.2,14,17,1,16,13,47,20,0,18/19
Benjamin Mendy,fr FRA,DF,Manchester City,24,1994,10,16,10,10,5,1,9,17,52.9,8,13,4,9,10,26,18,0,18/19
Nampalys Mendy,sn SEN,MF,Leicester City,26,1992,23.2,33,18,16,16,1,6,22,27.3,16,24,8,16,26,59,26,2,18/19
Chris Mepham,wls WAL,DF,Bournemouth,20,1997,9.4,9,3,9,0,0,7,11,63.6,4,12,5,7,14,23,57,2,18/19
Max Meyer,de GER,MF,Crystal Palace,22,1995,15.7,33,18,14,18,1,11,20,55,9,6,0,6,15,48,19,0,18/19
Luka Milivojević,rs SRB,MF,Crystal Palace,27,1991,38,90,69,36,47,7,39,91,42.9,52,47,15,32,72,162,68,3,18/19
James Milner,eng ENG,MFDF,Liverpool,32,1986,19.9,43,23,14,24,5,15,41,36.6,26,40,5,35,18,61,30,0,18/19
Yerry Mina,co COL,DF,Everton,23,1994,9.9,14,7,8,6,0,6,9,66.7,3,11,5,6,8,22,54,3,18/19
Tyrone Mings,eng ENG,DF,Bournemouth,25,1993,1.6,4,3,3,1,0,2,3,66.7,1,5,2,3,6,10,8,0,18/19
Aleksandar Mitrović,rs SRB,FW,Fulham,23,1994,36.4,19,9,3,13,3,5,15,33.3,10,22,8,14,6,25,53,0,18/19
Henrikh Mkhitaryan,am ARM,FWMF,Arsenal,29,1989,18.2,28,22,8,17,3,6,22,27.3,16,34,2,32,16,44,13,0,18/19
Nacho Monreal,es ESP,DF,Arsenal,32,1986,20.7,35,17,21,9,5,15,25,60,10,28,10,18,31,66,62,0,18/19
Martín Montoya,es ESP,DF,Brighton,27,1991,24.1,58,35,29,21,8,32,55,58.2,23,30,10,20,48,106,76,1,18/19
Aaron Mooy,au AUS,MFFW,Huddersfield,27,1990,25.9,62,42,19,27,16,21,52,40.4,31,43,7,36,14,76,22,0,18/19
Álvaro Morata,es ESP,FW,Chelsea,25,1992,10.5,8,5,0,5,3,1,7,14.3,6,6,1,5,0,8,6,0,18/19
Alberto Moreno,es ESP,DF,Liverpool,26,1992,1.7,3,2,1,2,0,1,3,33.3,2,1,0,1,2,5,0,0,18/19
Wes Morgan,jm JAM,DF,Leicester City,34,1984,21.4,27,15,14,12,1,6,7,85.7,1,24,10,14,32,59,109,1,18/19
Sean Morrison,eng ENG,DF,Cardiff City,27,1991,33.8,35,17,29,4,2,15,28,53.6,13,47,30,17,52,87,204,5,18/19
Victor Moses,ng NGA,FW,Chelsea,27,1990,0.3,0,0,0,0,0,0,0,,0,1,0,1,0,0,0,0,18/19
Steve Mounié,bj BEN,FW,Huddersfield,23,1994,19.8,9,6,3,4,2,2,12,16.7,10,10,1,9,5,14,15,0,18/19
Lucas Moura,br BRA,FWMF,Tottenham,25,1992,23.6,35,18,8,20,7,9,27,33.3,18,15,1,14,24,59,24,0,18/19
Lys Mousset,fr FRA,FW,Bournemouth,22,1996,4.1,3,1,1,1,1,1,4,25,3,3,0,3,1,4,3,0,18/19
João Moutinho,pt POR,MF,Wolves,31,1986,33.7,113,58,50,56,7,44,126,34.9,82,56,11,45,40,153,50,0,18/19
Jacob Murphy,eng ENG,MFDF,Newcastle Utd,23,1995,3.4,6,2,4,2,0,2,4,50,2,5,2,3,1,7,7,0,18/19
Josh Murphy,eng ENG,MFFW,Cardiff City,23,1995,20.2,26,17,15,7,4,9,29,31,20,30,0,30,11,37,17,0,18/19
Glenn Murray,eng ENG,FW,Brighton,34,1983,27.9,17,7,4,7,6,4,20,20,16,20,3,17,2,19,17,1,18/19
Shkodran Mustafi,de GER,DF,Arsenal,26,1992,29,62,45,42,17,3,31,40,77.5,9,34,17,17,58,120,168,1,18/19
Yoshinori Mutō,jp JPN,FWMF,Newcastle Utd,26,1992,5.8,8,4,3,5,0,2,7,28.6,5,9,0,9,5,13,3,1,18/19
Georges-Kévin N'Koudou,cm CMR,FW,Tottenham,23,1995,0.1,0,0,0,0,0,0,0,,0,0,0,0,0,0,0,0,18/19
Samir Nasri,fr FRA,MF,West Ham,31,1987,2.7,0,0,0,0,0,0,0,,0,1,0,1,1,1,1,0,18/19
Marc Navarro,es ESP,DF,Watford,23,1995,0.9,4,2,3,1,0,3,4,75,1,0,0,0,0,4,4,0,18/19
Wilfred Ndidi,ng NGA,MF,Leicester City,21,1996,36.6,142,98,66,67,9,46,95,48.4,49,64,9,55,83,225,85,2,18/19
Rúben Neves,pt POR,MF,Wolves,21,1997,33.4,75,32,33,36,6,27,83,32.5,56,57,18,39,73,148,46,3,18/19
Oumar Niasse,sn SEN,FW,Cardiff City,28,1990,10.3,12,3,1,5,6,4,8,50,4,7,0,7,2,14,7,0,18/19
Oumar Niasse,sn SEN,FW,Everton,28,1990,0.7,0,0,0,0,0,0,1,0,1,0,0,0,0,0,0,0,18/19
Eddie Nketiah,eng ENG,MFFW,Arsenal,19,1999,0.7,1,1,0,1,0,0,0,,0,0,0,0,0,1,1,0,18/19
Mark Noble,eng ENG,MF,West Ham,31,1987,25.5,47,26,19,24,4,17,52,32.7,35,17,2,15,21,68,13,0,18/19
Håvard Nordtveit,no NOR,DF,Fulham,28,1990,4,9,4,8,1,0,4,5,80,1,3,3,0,8,17,15,1,18/19
Will Norris,eng ENG,GK,Wolves,24,1993,0,0,0,0,0,0,0,0,,0,0,0,0,0,0,0,0,18/19
Michael Obafemi,ie IRL,FW,Southampton,18,2000,1.5,1,1,0,0,1,0,0,,0,1,1,0,1,2,0,0,18/19
Pedro Obiang,gq EQG,MF,West Ham,26,1992,12.5,41,23,23,16,2,18,43,41.9,25,27,9,18,12,53,18,0,18/19
Denis Odoi,gh GHA,DF,Fulham,30,1988,28.8,48,34,29,16,3,21,33,63.6,12,45,24,21,42,90,153,0,18/19
Angelo Ogbonna,it ITA,DF,West Ham,30,1988,20.8,31,13,23,6,2,14,23,60.9,9,29,19,10,35,66,101,0,18/19
Stefano Okaka,it ITA,FWMF,Watford,28,1989,0.3,0,0,0,0,0,0,0,,0,1,0,1,0,0,0,0,18/19
Shinji Okazaki,jp JPN,MFFW,Leicester City,32,1986,3.2,5,5,2,3,0,0,1,0,1,7,1,6,2,7,1,0,18/19
Divock Origi,be BEL,FW,Liverpool,23,1995,4.1,6,1,2,3,1,1,4,25,3,2,0,2,0,6,2,0,18/19
Nicolás Otamendi,ar ARG,DF,Manchester City,30,1988,13.7,24,14,17,6,1,5,9,55.6,4,6,4,2,29,53,56,1,18/19
Alex Oxlade-Chamberlain,eng ENG,MF,Liverpool,24,1993,0.2,1,1,0,1,0,1,1,100,0,0,0,0,1,2,0,0,18/19
Mesut Özil,de GER,MFFW,Arsenal,29,1988,19.3,12,5,6,3,3,3,21,14.3,18,10,2,8,4,16,5,0,18/19
Emerson Palmieri,it ITA,DF,Chelsea,23,1994,7.4,14,9,6,5,3,6,10,60,4,11,1,10,8,22,14,0,18/19
Sokratis Papastathopoulos,gr GRE,DF,Arsenal,30,1988,24.4,42,25,30,11,1,15,28,53.6,13,34,17,17,26,68,112,1,18/19
Callum Paterson,sct SCO,FWMF,Cardiff City,23,1994,22.2,21,14,7,7,7,5,26,19.2,21,23,2,21,8,29,29,0,18/19
Rui Patrício,pt POR,GK,Wolves,30,1988,37,2,0,2,0,0,2,3,66.7,1,0,0,0,1,3,7,4,18/19
Pedro,es ESP,FW,Chelsea,31,1987,19.8,27,14,11,10,6,9,35,25.7,26,13,2,11,18,45,8,1,18/19
Lee Peltier,eng ENG,DF,Cardiff City,31,1986,17.2,39,25,27,11,1,15,27,55.6,12,18,12,6,18,57,60,0,18/19
Andreas Pereira,br BRA,MF,Manchester Utd,22,1996,6.7,8,6,5,2,1,4,15,26.7,11,9,2,7,11,19,8,1,18/19
Ricardo Pereira,pt POR,DFFW,Leicester City,24,1993,34.7,118,66,66,40,12,54,112,48.2,58,60,6,54,60,178,130,1,18/19
Roberto Pereyra,ar ARG,MF,Watford,27,1991,31.3,21,12,10,10,1,7,24,29.2,17,26,0,26,24,45,27,2,18/19
Ayoze Pérez,es ESP,MFFW,Newcastle Utd,25,1993,32.4,59,22,24,28,7,17,63,27,46,55,4,51,42,101,33,1,18/19
Lucas Pérez,es ESP,FWMF,West Ham,29,1988,5.3,6,4,3,2,1,1,3,33.3,2,2,1,1,2,8,2,0,18/19
Jordan Pickford,eng ENG,GK,Everton,24,1994,38,0,0,0,0,0,0,0,,0,0,0,0,0,0,20,8,18/19
Paul Pogba,fr FRA,MF,Manchester Utd,25,1993,33.4,47,30,21,21,5,17,43,39.5,26,30,9,21,18,65,39,0,18/19
Alex Pritchard,eng ENG,MFFW,Huddersfield,25,1993,23.1,36,24,10,18,8,10,35,28.6,25,26,2,24,17,53,9,0,18/19
Sebastian Prödl,at AUT,DF,Watford,31,1987,0.1,0,0,0,0,0,0,0,,0,0,0,0,0,0,0,0,18/19
Davy Pröpper,nl NED,MF,Brighton,26,1991,28.3,50,28,23,21,6,16,52,30.8,36,21,6,15,53,103,37,0,18/19
Jason Puncheon,eng ENG,MF,Crystal Palace,32,1986,0.1,1,1,1,0,0,0,0,,0,0,0,0,0,1,0,0,18/19
Jason Puncheon,eng ENG,MF,Huddersfield,32,1986,4.2,7,4,1,5,1,1,7,14.3,6,3,1,2,3,10,8,0,18/19
Collin Quaner,de GER,FW,Huddersfield,27,1991,0.4,0,0,0,0,0,0,1,0,1,0,0,0,0,0,0,0,18/19
Domingos Quina,pt POR,MF,Watford,18,1999,3.8,9,7,3,5,1,3,11,27.3,8,6,0,6,3,12,1,0,18/19
Joe Ralls,eng ENG,MF,Cardiff City,24,1993,21.8,45,23,21,21,3,10,33,30.3,23,21,6,15,29,74,30,0,18/19
Aaron Ramsey,wls WAL,MF,Arsenal,27,1990,14.8,34,18,11,15,8,7,25,28,18,7,1,6,9,43,3,0,18/19
Kayne Ramsey,eng ENG,DF,Southampton,17,2000,1,0,0,0,0,0,0,0,,0,0,0,0,0,0,7,0,18/19
Marcus Rashford,eng ENG,FW,Manchester Utd,20,1997,25.9,24,12,4,12,8,7,29,24.1,22,27,0,27,3,27,24,0,18/19
Tim Ream,us USA,DF,Fulham,30,1987,22.7,23,14,16,7,0,14,28,50,14,19,10,9,25,48,80,2,18/19
Nathan Redmond,eng ENG,MFFW,Southampton,24,1994,36.3,45,22,14,19,12,14,41,34.1,27,54,2,52,20,65,23,1,18/19
Bobby Reid,jm JAM,FWMF,Cardiff City,25,1993,15.8,16,9,6,7,3,3,8,37.5,5,13,0,13,3,19,12,0,18/19
Declan Rice,eng ENG,MF,West Ham,19,1999,33.4,98,60,35,58,5,38,88,43.2,50,51,12,39,52,150,56,0,18/19
Jazz Richards,wls WAL,DFMF,Cardiff City,27,1991,1.5,0,0,0,0,0,0,1,0,1,2,1,1,2,2,5,0,18/19
Richarlison,br BRA,FWMF,Everton,21,1997,29.6,49,34,19,20,10,8,24,33.3,16,30,2,28,16,65,39,0,18/19
Diego Rico,es ESP,DFMF,Bournemouth,25,1993,6.8,14,9,8,2,4,4,12,33.3,8,13,2,11,14,28,20,0,18/19
Sergio Rico,es ESP,GK,Fulham,24,1993,29,1,1,1,0,0,1,1,100,0,0,0,0,1,2,13,5,18/19
Matt Ritchie,sct SCO,DFMF,Newcastle Utd,28,1989,32.5,70,44,35,27,8,19,47,40.4,28,34,11,23,51,121,76,1,18/19
Andrew Robertson,sct SCO,DF,Liverpool,24,1994,35.7,80,49,41,31,8,39,70,55.7,31,33,6,27,29,109,57,3,18/19
Marcos Rojo,ar ARG,DF,Manchester Utd,28,1990,2.4,5,3,3,2,0,1,6,16.7,5,3,2,1,6,11,9,1,18/19
Oriol Romeu,es ESP,MF,Southampton,26,1991,23.7,81,46,39,38,4,32,77,41.6,45,43,17,26,52,133,44,1,18/19
Salomón Rondón,ve VEN,FW,Newcastle Utd,28,1989,28.9,8,3,2,4,2,4,24,16.7,20,14,3,11,5,13,39,0,18/19
Danny Rose,eng ENG,DF,Tottenham,28,1990,20,49,31,26,16,7,20,32,62.5,12,24,4,20,24,73,28,3,18/19
Aaron Rowe,eng ENG,FW,Huddersfield,17,2000,0.8,1,0,1,0,0,0,0,,0,0,0,0,1,2,1,0,18/19
John Ruddy,eng ENG,GK,Wolves,31,1986,1,0,0,0,0,0,0,0,,0,0,0,0,0,0,0,0,18/19
Antonio Rüdiger,de GER,DF,Chelsea,25,1993,31.9,34,16,27,6,1,15,27,55.6,12,15,8,7,32,66,96,1,18/19
Mathew Ryan,au AUS,GK,Brighton,26,1992,34,1,0,1,0,0,1,2,50,1,0,0,0,0,1,13,1,18/19
Abdelhamid Sabiri,ma MAR,FW,Huddersfield,21,1996,0.5,2,1,1,1,0,0,0,,0,1,0,1,1,3,0,0,18/19
Romain Saïss,ma MAR,MFDF,Wolves,28,1990,12.8,39,26,23,14,2,20,37,54.1,17,25,12,13,26,65,61,0,18/19
Bukayo Saka,eng ENG,FW,Arsenal,16,2001,0.1,0,0,0,0,0,0,0,,0,0,0,0,0,0,0,0,18/19
Mamadou Sakho,fr FRA,DF,Crystal Palace,28,1990,26.8,25,16,22,3,0,11,18,61.1,7,26,16,10,41,66,136,2,18/19
Bakary Sako,ml MLI,FW,Crystal Palace,30,1988,0.3,2,1,2,0,0,1,1,100,0,0,0,0,0,2,0,0,18/19
Mohamed Salah,eg EGY,FW,Liverpool,26,1992,36.1,21,9,3,11,7,5,16,31.3,11,9,0,9,5,26,6,0,18/19
Alexis Sánchez,cl CHI,FWMF,Manchester Utd,29,1988,9.8,17,10,5,9,3,5,13,38.5,8,7,0,7,9,26,2,0,18/19
Carlos Sánchez,co COL,MF,West Ham,32,1986,2.7,4,3,4,0,0,3,8,37.5,5,1,0,1,1,5,5,2,18/19
Davinson Sánchez,co COL,DF,Tottenham,22,1996,21.6,37,20,28,9,0,20,37,54.1,17,17,9,8,30,67,103,2,18/19
Leroy Sané,de GER,FW,Manchester City,22,1996,20.7,24,15,8,7,9,2,23,8.7,21,21,2,19,8,32,2,0,18/19
Fabian Schär,ch SUI,DF,Newcastle Utd,26,1991,22.2,60,39,37,19,4,24,50,48,26,40,16,24,67,127,145,2,18/19
Christopher Schindler,de GER,DF,Huddersfield,28,1990,36.2,61,36,46,14,1,27,47,57.4,20,69,34,35,70,131,138,4,18/19
Jeffrey Schlupp,gh GHA,MFFW,Crystal Palace,25,1992,18.6,41,20,18,18,5,10,27,37,17,30,8,22,19,60,27,1,18/19
Kasper Schmeichel,dk DEN,GK,Leicester City,31,1986,38,1,1,1,0,0,1,1,100,0,0,0,0,3,4,14,3,18/19
Morgan Schneiderlin,fr FRA,MF,Everton,28,1989,9.3,24,16,11,11,2,6,14,42.9,8,16,3,13,15,39,16,0,18/19
André Schürrle,de GER,FWMF,Fulham,27,1990,18.2,30,19,14,10,6,12,42,28.6,30,16,1,15,8,38,17,1,18/19
Ken Sema,se SWE,MFFW,Watford,24,1993,8.4,15,7,7,5,3,9,21,42.9,12,7,0,7,8,23,5,0,18/19
Jean Seri,ci CIV,MF,Fulham,27,1991,24.9,41,28,20,20,1,13,45,28.9,32,40,9,31,32,73,17,4,18/19
Ryan Sessegnon,eng ENG,FWDF,Fulham,18,2000,25.6,22,14,8,8,6,6,22,27.3,16,25,2,23,19,41,49,1,18/19
Xherdan Shaqiri,ch SUI,FWMF,Liverpool,26,1991,11.8,14,4,3,9,2,9,19,47.4,10,6,1,5,6,20,6,0,18/19
Luke Shaw,eng ENG,DF,Manchester Utd,23,1995,28.8,55,29,17,31,7,28,47,59.6,19,42,12,30,21,76,93,2,18/19
Jonjo Shelvey,eng ENG,MF,Newcastle Utd,26,1992,10.5,22,12,10,9,3,8,17,47.1,9,10,3,7,7,29,15,0,18/19
Gylfi Sigurðsson,is ISL,MF,Everton,28,1989,34.6,56,36,20,25,11,16,47,34,31,38,4,34,28,84,24,0,18/19
Adrien Silva,pt POR,MF,Leicester City,29,1989,1,2,2,0,1,1,0,2,0,2,1,0,1,1,3,1,0,18/19
Bernardo Silva,pt POR,MFFW,Manchester City,23,1994,31.7,52,39,18,21,13,16,67,23.9,51,47,3,44,25,77,26,1,18/19
David Silva,es ESP,MF,Manchester City,32,1986,26.7,30,18,12,11,7,1,20,5,19,18,1,17,22,52,15,0,18/19
Xande Silva,pt POR,FW,West Ham,21,1997,0.2,0,0,0,0,0,0,0,,0,1,0,1,0,0,0,0,18/19
Danny Simpson,eng ENG,DF,Leicester City,31,1987,3.2,11,3,8,3,0,3,5,60,2,7,3,4,6,17,20,0,18/19
Jack Simpson,eng ENG,DF,Bournemouth,21,1996,4.5,9,5,8,1,0,6,9,66.7,3,5,4,1,9,18,25,2,18/19
Josh Sims,eng ENG,MF,Southampton,21,1997,2.4,1,0,1,0,0,1,3,33.3,2,2,0,2,1,2,1,0,18/19
Moussa Sissoko,fr FRA,MFFW,Tottenham,28,1989,25.9,36,25,18,14,4,15,29,51.7,14,31,4,27,16,52,25,2,18/19
Oliver Skipp,eng ENG,MF,Tottenham,17,2000,2.4,7,3,4,3,0,4,6,66.7,2,2,1,1,1,8,7,0,18/19
Callum Slattery,eng ENG,MF,Southampton,19,1999,1.2,4,3,0,4,0,3,7,42.9,4,1,1,0,2,6,1,0,18/19
Chris Smalling,eng ENG,DF,Manchester Utd,28,1989,23.6,30,17,21,9,0,11,17,64.7,6,37,25,12,26,56,109,1,18/19
Adam Smith,eng ENG,DFMF,Bournemouth,27,1991,23,46,32,26,14,6,19,41,46.3,22,26,7,19,31,77,68,1,18/19
Tommy Smith,eng ENG,DF,Huddersfield,26,1992,12.7,26,13,14,11,1,10,25,40,15,12,4,8,18,44,25,0,18/19
Robert Snodgrass,sct SCO,MF,West Ham,30,1987,24.7,44,27,18,24,2,13,46,28.3,33,24,4,20,11,55,23,0,18/19
Cédric Soares,pt POR,DF,Southampton,26,1991,16.6,22,16,15,6,1,9,15,60,6,21,5,16,22,44,60,2,18/19
Ramadan Sobhi,eg EGY,FWMF,Huddersfield,21,1997,0.9,1,1,0,1,0,0,0,,0,2,0,2,1,2,0,0,18/19
Dominic Solanke,eng ENG,FWMF,Bournemouth,20,1997,3.9,8,3,1,4,3,1,8,12.5,7,4,1,3,2,10,9,0,18/19
Pape Souaré,sn SEN,DF,Crystal Palace,28,1990,0,0,0,0,0,0,0,0,,0,0,0,0,1,1,0,0,18/19
Çağlar Söyüncü,tr TUR,DF,Leicester City,22,1996,4.1,5,2,4,1,0,3,6,50,3,8,5,3,7,12,22,3,18/19
Julián Speroni,ar ARG,GK,Crystal Palace,39,1979,1,0,0,0,0,0,0,0,,0,0,0,0,0,0,1,2,18/19
Junior Stanislas,eng ENG,MFFW,Bournemouth,28,1989,11.5,12,6,5,4,3,3,7,42.9,4,8,1,7,2,14,15,0,18/19
Dale Stephens,eng ENG,MF,Brighton,29,1989,27.6,83,57,37,41,5,28,74,37.8,46,33,13,20,46,129,47,0,18/19
Jack Stephens,eng ENG,DF,Southampton,24,1994,18.9,25,13,17,7,1,16,28,57.1,12,25,13,12,37,62,96,2,18/19
Raheem Sterling,eng ENG,FW,Manchester City,23,1994,30.8,32,16,11,12,9,9,25,36,16,28,3,25,17,49,4,0,18/19
John Stones,eng ENG,DF,Manchester City,24,1994,19.6,16,11,9,5,2,4,9,44.4,5,15,9,6,14,30,64,1,18/19
Daniel Sturridge,eng ENG,FWMF,Liverpool,28,1989,5.7,3,3,1,1,1,2,3,66.7,1,4,0,4,1,4,0,0,18/19
Denis Suárez,es ESP,MFFW,Arsenal,24,1994,0.8,1,1,0,1,0,0,5,0,5,0,0,0,1,2,0,0,18/19
Isaac Success,ng NGA,FWMF,Watford,22,1996,11.7,15,12,4,8,3,2,5,40,3,6,0,6,2,17,11,0,18/19
Ki Sung-yueng,kr KOR,MF,Newcastle Utd,29,1989,14.5,14,10,5,8,1,3,12,25,9,11,1,10,19,33,20,0,18/19
Andrew Surman,eng ENG,MF,Bournemouth,31,1986,16,11,6,6,5,0,3,13,23.1,10,20,7,13,10,21,34,1,18/19
Sam Surridge,eng ENG,MFFW,Bournemouth,20,1998,0.1,1,0,0,0,1,0,0,,0,0,0,0,0,1,0,0,18/19
Alexander Sørloth,no NOR,FW,Crystal Palace,22,1995,2.1,2,1,0,0,2,1,2,50,1,0,0,0,0,2,3,0,18/19
Matt Targett,eng ENG,DF,Southampton,22,1995,13.2,27,19,15,7,5,12,26,46.2,14,19,3,16,27,54,42,0,18/19
James Tarkowski,eng ENG,DF,Burnley,25,1992,34.3,71,36,52,18,1,29,50,58,21,72,56,16,42,113,240,2,18/19
Charlie Taylor,eng ENG,DF,Burnley,24,1993,36,55,26,37,15,3,24,50,48,26,74,35,39,40,95,120,0,18/19
Youri Tielemans,be BEL,MF,Leicester City,21,1997,12.1,17,8,5,9,3,5,17,29.4,12,13,2,11,5,22,13,1,18/19
James Tomkins,eng ENG,DF,Crystal Palace,29,1989,28.4,34,20,27,7,0,15,28,53.6,13,23,10,13,34,68,184,3,18/19
Lucas Torreira,uy URU,MF,Arsenal,22,1996,26.5,65,39,24,32,9,25,57,43.9,32,34,7,27,41,106,33,2,18/19
Cenk Tosun,tr TUR,FW,Everton,27,1991,11.8,13,9,3,6,4,4,13,30.8,9,12,0,12,5,18,3,0,18/19
Andros Townsend,eng ENG,FWMF,Crystal Palace,27,1991,33.4,62,35,38,16,8,35,89,39.3,54,48,5,43,38,100,28,0,18/19
Adama Traoré,es ESP,FWMF,Wolves,22,1996,10,16,13,11,3,2,4,9,44.4,5,11,0,11,6,22,7,0,18/19
Mark Travers,ie IRL,GK,Bournemouth,19,1999,2,0,0,0,0,0,0,0,,0,0,0,0,0,0,2,0,18/19
Kieran Trippier,eng ENG,DF,Tottenham,27,1990,25.3,67,37,43,16,8,37,62,59.7,25,38,5,33,23,90,77,2,18/19
Antonio Valencia,ec ECU,DF,Manchester Utd,32,1985,5.2,8,6,2,4,2,3,4,75,1,9,0,9,5,13,10,0,18/19
Yan Valery,tn TUN,DF,Southampton,19,1999,19,42,36,26,10,6,16,29,55.2,13,24,3,21,22,64,72,1,18/19
Virgil van Dijk,nl NED,DF,Liverpool,27,1991,37.6,38,28,26,11,1,14,14,100,0,29,18,11,40,78,201,1,18/19
Jamie Vardy,eng ENG,FW,Leicester City,31,1987,30.3,14,8,3,6,5,4,17,23.5,13,16,1,15,6,20,28,0,18/19
Jan Vertonghen,be BEL,DF,Tottenham,31,1987,21.2,39,24,17,20,2,14,24,58.3,10,18,11,7,32,71,81,0,18/19
Jannik Vestergaard,dk DEN,DF,Southampton,25,1992,22.5,53,33,37,13,3,28,45,62.2,17,35,20,15,35,88,174,1,18/19
Luciano Vietto,ar ARG,FWMF,Fulham,24,1993,11,15,11,5,5,5,4,19,21.1,15,9,0,9,6,21,5,0,18/19
Rúben Vinagre,pt POR,DFMF,Wolves,19,1999,7.9,14,9,7,7,0,2,5,40,3,10,2,8,14,28,16,1,18/19
Sam Vokes,wls WAL,FW,Burnley,28,1989,10.2,4,2,1,2,1,0,0,,0,2,1,1,0,4,17,0,18/19
Michel Vorm,nl NED,GK,Tottenham,34,1983,2,0,0,0,0,0,0,0,,0,0,0,0,0,0,1,0,18/19
Matěj Vydra,cz CZE,FW,Burnley,26,1992,3.5,2,1,0,1,1,0,3,0,3,4,1,3,1,3,6,0,18/19
Theo Walcott,eng ENG,FWMF,Everton,29,1989,23.5,27,17,11,9,7,10,22,45.5,12,17,1,16,22,49,8,0,18/19
Kyle Walker,eng ENG,DF,Manchester City,28,1990,30.9,40,26,20,20,0,24,38,63.2,14,19,5,14,36,76,58,2,18/19
Kyle Walker-Peters,eng ENG,DF,Tottenham,21,1997,4.2,7,4,4,2,1,3,4,75,1,5,1,4,4,11,6,0,18/19
Aaron Wan-Bissaka,eng ENG,DF,Crystal Palace,20,1997,34.8,129,90,90,33,6,55,65,84.6,10,49,16,33,84,213,161,0,18/19
Victor Wanyama,ke KEN,MF,Tottenham,27,1991,5.7,13,13,8,5,0,6,12,50,6,9,3,6,7,20,11,0,18/19
Danny Ward,eng ENG,FW,Cardiff City,26,1991,4.9,2,1,0,1,1,0,3,0,3,3,1,2,0,2,9,0,18/19
Joel Ward,eng ENG,DF,Crystal Palace,28,1989,6.1,12,7,7,4,1,3,10,30,7,2,0,2,10,22,35,0,18/19
Stephen Ward,ie IRL,DF,Burnley,32,1985,2.5,4,2,1,2,1,1,4,25,3,3,1,2,4,8,14,0,18/19
James Ward-Prowse,eng ENG,MFDF,Southampton,23,1994,21.6,36,17,19,13,4,14,43,32.6,29,30,6,24,27,63,59,0,18/19
Danny Welbeck,eng ENG,FWMF,Arsenal,27,1990,1.7,3,2,0,2,1,0,0,,0,2,0,2,1,4,2,0,18/19
Ashley Westwood,eng ENG,MF,Burnley,28,1990,31.4,58,30,24,27,7,14,39,35.9,25,38,9,29,47,105,42,2,18/19
Connor Wickham,eng ENG,FWMF,Crystal Palace,25,1993,0.7,0,0,0,0,0,0,0,,0,0,0,0,0,0,2,0,18/19
Georginio Wijnaldum,nl NED,MF,Liverpool,27,1990,30.3,41,28,14,20,7,14,27,51.9,13,21,7,14,21,62,24,0,18/19
Danny Williams,us USA,MF,Huddersfield,29,1989,1.1,0,0,0,0,0,0,0,,0,4,1,3,1,1,2,0,18/19
Willian,br BRA,FW,Chelsea,29,1988,23.3,35,21,11,15,9,9,25,36,16,16,1,15,14,49,12,2,18/19
Joe Willock,eng ENG,MFFW,Arsenal,18,1999,0.7,1,0,0,1,0,0,0,,0,1,0,1,1,2,0,0,18/19
Ben Wilmot,eng ENG,MFDF,Watford,18,1999,0.3,0,0,0,0,0,0,1,0,1,2,1,1,0,0,1,0,18/19
Jack Wilshere,eng ENG,MF,West Ham,26,1992,4.4,7,4,1,4,2,2,6,33.3,4,3,1,2,7,14,0,0,18/19
Callum Wilson,eng ENG,FW,Bournemouth,26,1992,28.1,9,7,4,3,2,0,8,0,8,14,4,10,4,13,16,0,18/19
Harry Winks,eng ENG,MF,Tottenham,22,1996,17.7,22,13,12,9,1,5,30,16.7,25,19,3,16,21,43,19,0,18/19
Chris Wood,nz NZL,FW,Burnley,26,1991,28.8,12,8,0,7,5,5,17,29.4,12,17,4,13,3,15,26,0,18/19
Granit Xhaka,ch SUI,MFDF,Arsenal,25,1992,27.8,52,29,29,20,3,24,59,40.7,35,35,9,26,36,88,56,3,18/19
Andriy Yarmolenko,ua UKR,MFFW,West Ham,28,1989,5.1,4,1,2,1,1,4,6,66.7,2,4,1,3,2,6,4,2,18/19
DeAndre Yedlin,us USA,DF,Newcastle Utd,25,1993,27.5,54,32,36,14,4,19,41,46.3,22,36,10,26,28,82,88,0,18/19
Maya Yoshida,jp JPN,DF,Southampton,29,1988,16.9,16,12,5,10,1,4,13,30.8,9,24,20,4,42,58,103,1,18/19
Ashley Young,eng ENG,DF,Manchester Utd,33,1985,28.5,52,32,34,16,2,20,39,51.3,19,36,10,26,55,107,74,0,18/19
Pablo Zabaleta,ar ARG,DF,West Ham,33,1985,23.2,47,24,26,15,6,17,44,38.6,27,39,15,24,48,95,96,3,18/19
Wilfried Zaha,ci CIV,FW,Crystal Palace,25,1992,33.7,39,20,11,23,5,12,34,35.3,22,19,0,19,10,49,4,0,18/19
Andre-Frank Zambo Anguissa,cm CMR,MF,Fulham,22,1995,16.9,48,29,23,20,5,18,52,34.6,34,25,6,19,34,82,32,0,18/19
Davide Zappacosta,it ITA,DF,Chelsea,26,1992,1.4,0,0,0,0,0,0,1,0,1,0,0,0,3,3,5,0,18/19
Oleksandr Zinchenko,ua UKR,DF,Manchester City,21,1996,12.8,34,20,13,15,6,14,33,42.4,19,14,3,11,20,54,19,1,18/19
Kenneth Zohore,dk DEN,FW,Cardiff City,24,1994,8.4,3,2,0,3,0,1,3,33.3,2,4,2,2,2,5,5,0,18/19
Kurt Zouma,fr FRA,DF,Everton,23,1994,29,32,21,16,14,2,4,11,36.4,7,27,12,15,54,86,126,2,18/19
Patrick van Aanholt,nl NED,DF,Crystal Palace,26,1990,24.3,47,32,29,15,3,16,34,47.1,18,24,5,19,47,94,64,2,17/18
Rolando Aarons,eng ENG,MFFW,Newcastle Utd,21,1995,1.5,4,4,3,1,0,4,6,66.7,2,3,0,3,1,5,0,0,17/18
Tammy Abraham,eng ENG,FW,Swansea City,19,1997,19.2,10,8,1,7,2,1,13,7.7,12,8,1,7,1,11,11,0,17/18
Charlie Adam,sct SCO,MF,Stoke City,31,1985,4.6,9,5,2,5,2,5,17,29.4,12,2,0,2,9,18,11,2,17/18
Adrián,es ESP,GK,West Ham,30,1987,19,2,1,2,0,0,1,4,25,3,1,0,1,0,2,15,1,17/18
Ibrahim Afellay,nl NED,MF,Stoke City,31,1986,1.8,3,3,0,3,0,1,2,50,1,1,0,1,1,4,1,0,17/18
Benik Afobe,cd COD,FW,Bournemouth,24,1993,6.8,4,3,1,2,1,1,6,16.7,5,4,0,4,0,4,6,0,17/18
Sergio Agüero,ar ARG,FW,Manchester City,29,1988,21.8,9,6,2,6,1,2,17,11.8,15,12,1,11,6,15,3,0,17/18
Nathan Aké,nl NED,DF,Bournemouth,22,1995,37.3,53,32,34,16,3,22,40,55,18,47,24,23,48,101,246,2,17/18
Marc Albrighton,eng ENG,MFFW,Leicester City,27,1989,28.2,52,33,16,29,7,16,52,30.8,36,32,4,28,27,79,34,0,17/18
Toby Alderweireld,be BEL,DF,Tottenham,28,1989,13.1,19,13,7,11,1,8,15,53.3,7,11,5,6,4,23,55,0,17/18
Trent Alexander-Arnold,eng ENG,DF,Liverpool,18,1998,17.5,37,25,23,9,5,22,36,61.1,14,20,5,15,28,65,46,1,17/18
Joe Allen,wls WAL,MF,Stoke City,27,1990,34.9,96,62,41,43,12,27,87,31,60,43,9,34,58,154,68,1,17/18
Dele Alli,eng ENG,MFFW,Tottenham,21,1996,32.9,46,30,15,21,10,8,34,23.5,26,33,7,26,19,65,22,1,17/18
Marcos Alonso,es ESP,DFMF,Chelsea,26,1990,31.7,51,33,30,18,3,23,44,52.3,21,36,5,31,47,98,76,1,17/18
Daniel Amartey,gh GHA,DF,Leicester City,22,1994,5.4,8,4,7,1,0,3,7,42.9,4,7,3,4,7,15,21,1,17/18
Ethan Ampadu,wls WAL,DF,Chelsea,16,2000,0.1,1,1,0,1,0,0,0,,0,0,0,0,0,1,2,0,17/18
Nordin Amrabat,ma MAR,FW,Watford,30,1987,2.2,6,3,1,5,0,1,3,33.3,2,1,0,1,0,6,2,0,17/18
Michail Antonio,jm JAM,FWMF,West Ham,27,1990,15,15,9,7,6,2,4,14,28.6,10,14,0,14,13,28,16,0,17/18
Scott Arfield,ca CAN,MFFW,Burnley,28,1988,14.8,36,26,20,13,3,19,44,43.2,25,22,1,21,11,47,24,0,17/18
Marko Arnautović,at AUT,FWMF,West Ham,28,1989,25.7,21,16,9,8,4,7,19,36.8,12,20,3,17,13,34,35,0,17/18
Harry Arter,ie IRL,MF,Bournemouth,27,1989,10.7,19,16,10,7,2,6,23,26.1,17,18,5,13,9,28,6,0,17/18
Christian Atsu,gh GHA,FWMF,Newcastle Utd,25,1992,19.8,17,16,10,7,0,7,20,35,13,35,5,30,13,30,27,1,17/18
Pierre-Emerick Aubameyang,ga GAB,FW,Arsenal,28,1989,11.7,5,4,3,2,0,1,7,14.3,6,14,1,13,3,8,7,0,17/18
Serge Aurier,ci CIV,DF,Tottenham,24,1992,15.9,48,27,27,13,8,11,31,35.5,20,20,1,19,31,79,54,1,17/18
Charlie Austin,eng ENG,FW,Southampton,28,1989,11.5,7,5,1,3,3,3,10,30,7,15,3,12,1,8,10,0,17/18
André Ayew,gh GHA,MFFW,West Ham,27,1989,9.9,19,14,6,10,3,6,19,31.6,13,5,0,5,4,23,3,0,17/18
André Ayew,gh GHA,MFFW,Swansea City,27,1989,10.6,15,10,3,10,2,2,13,15.4,11,13,1,12,5,20,8,0,17/18
Jordan Ayew,gh GHA,FWMF,Swansea City,25,1991,31.7,82,60,20,35,27,15,54,27.8,39,43,3,40,24,106,20,1,17/18
César Azpilicueta,es ESP,DF,Chelsea,27,1989,37,80,59,47,26,7,27,54,50,27,48,22,26,54,134,135,1,17/18
Eric Bailly,ci CIV,DF,Manchester Utd,23,1994,11.1,17,10,10,5,2,5,12,41.7,7,11,6,5,25,42,58,1,17/18
Leighton Baines,eng ENG,DF,Everton,32,1984,21.2,25,13,18,3,4,9,14,64.3,5,18,6,12,25,50,56,0,17/18
Tiemoué Bakayoko,fr FRA,MF,Chelsea,22,1994,23.6,64,41,25,32,7,16,48,33.3,32,23,6,17,37,101,38,4,17/18
Sam Baldock,eng ENG,FW,Brighton,28,1989,0.4,0,0,0,0,0,0,0,,0,0,0,0,0,0,0,0,17/18
Beni Baningime,cd COD,MF,Everton,18,1998,2.2,6,2,1,2,3,0,4,0,4,5,1,4,2,8,2,0,17/18
Phil Bardsley,sct SCO,DF,Burnley,32,1985,12.5,17,16,9,7,1,4,11,36.4,7,22,6,16,22,39,77,0,17/18
Ross Barkley,eng ENG,MF,Chelsea,23,1993,1.4,0,0,0,0,0,0,1,0,1,3,1,2,0,0,2,0,17/18
Ashley Barnes,eng ENG,FW,Burnley,27,1989,24.1,21,14,1,14,6,5,29,17.2,24,26,5,21,2,23,19,0,17/18
Harvey Barnes,eng ENG,MFFW,Leicester City,19,1997,0.1,0,0,0,0,0,0,0,,0,0,0,0,0,0,0,0,17/18
Gareth Barry,eng ENG,MF,West Brom,36,1981,21.4,35,19,17,14,4,15,45,33.3,30,19,11,8,14,49,34,0,17/18
Kyle Bartley,eng ENG,DF,Swansea City,26,1991,2.6,3,2,3,0,0,2,2,100,0,6,6,0,4,7,21,0,17/18
Michy Batshuayi,be BEL,FW,Chelsea,23,1993,4,5,4,2,3,0,1,3,33.3,2,0,0,0,1,6,3,0,17/18
Moritz Bauer,at AUT,DFMF,Stoke City,25,1992,14.5,24,17,17,7,0,10,26,38.5,16,9,1,8,12,36,48,0,17/18
Jan Bednarek,pl POL,DF,Southampton,21,1996,4.7,6,3,6,0,0,3,6,50,3,2,1,1,5,11,27,0,17/18
Asmir Begović,ba BIH,GK,Bournemouth,30,1987,38,0,0,0,0,0,0,2,0,2,0,0,0,2,2,16,7,17/18
Héctor Bellerín,es ESP,DF,Arsenal,22,1995,33.9,57,43,36,12,9,25,52,48.1,27,42,8,34,23,80,89,4,17/18
Yohan Benalouane,tn TUN,DF,Leicester City,30,1987,1,7,3,6,1,0,4,6,66.7,2,1,1,0,1,8,4,0,17/18
Christian Benteke,be BEL,FW,Crystal Palace,26,1990,24.9,11,4,3,7,1,2,17,11.8,15,15,3,12,3,14,44,0,17/18
Saido Berahino,bi BDI,FW,Stoke City,23,1993,5.5,2,2,0,1,1,0,1,0,1,4,1,3,1,3,2,0,17/18
Jóhann Berg Guðmundsson,is ISL,MF,Burnley,26,1990,31.5,43,27,16,19,8,20,47,42.6,27,21,1,20,34,77,43,0,17/18
Ryan Bertrand,eng ENG,DF,Southampton,27,1989,34.8,48,35,27,17,4,19,31,61.3,12,28,9,19,44,92,74,0,17/18
Muhamed Bešić,ba BIH,MF,Everton,24,1992,0.5,1,1,1,0,0,1,3,33.3,2,2,2,0,0,1,1,0,17/18
Philip Billing,dk DEN,MF,Huddersfield,21,1996,8.5,25,16,11,11,3,8,22,36.4,14,17,1,16,18,43,19,0,17/18
Mame Biram Diouf,sn SEN,FWDF,Stoke City,29,1987,28.8,48,36,26,15,7,8,21,38.1,13,22,0,22,14,62,76,1,17/18
Daley Blind,nl NED,DFMF,Manchester Utd,27,1990,4,6,4,3,2,1,2,7,28.6,5,3,0,3,7,13,14,0,17/18
Jeremie Boga,ci CIV,MF,Chelsea,20,1997,0.2,0,0,0,0,0,0,0,,0,0,0,0,0,0,0,0,17/18
Yannick Bolasie,cd COD,FW,Everton,28,1989,9.5,8,7,4,1,3,2,7,28.6,5,5,0,5,4,12,8,0,17/18
Gaëtan Bong,cm CMR,DF,Brighton,29,1988,24.8,39,32,25,11,3,15,26,57.7,11,24,6,18,40,79,81,1,17/18
Wilfried Bony,ci CIV,FW,Swansea City,28,1988,7.9,5,4,2,2,1,1,5,20,4,4,1,3,2,7,15,0,17/18
Sofiane Boufal,ma MAR,FWMF,Southampton,23,1993,13.5,37,24,12,14,11,12,35,34.3,23,20,1,19,6,43,6,0,17/18
Robbie Brady,ie IRL,MF,Burnley,25,1992,14.2,32,21,14,17,1,8,28,28.6,20,17,3,14,7,39,29,0,17/18
Claudio Bravo,cl CHI,GK,Manchester City,34,1983,2.5,0,0,0,0,0,0,1,0,1,0,0,0,0,0,0,0,17/18
Miguel Britos,uy URU,DF,Watford,32,1985,8.9,15,11,10,5,0,6,11,54.5,5,9,1,8,12,27,45,1,17/18
Leon Britton,eng ENG,MF,Swansea City,34,1982,3.4,6,5,0,5,1,5,8,62.5,3,3,1,2,1,7,1,0,17/18
Izzy Brown,eng ENG,MFFW,Brighton,20,1997,3.5,3,3,2,1,0,1,7,14.3,6,3,0,3,1,4,3,0,17/18
Bruno,es ESP,DF,Brighton,36,1980,22.4,30,17,21,6,3,14,22,63.6,8,17,11,6,38,68,76,0,17/18
Chris Brunt,nir NIR,MFDF,West Brom,32,1984,21.3,41,24,19,21,1,11,31,35.5,20,28,4,24,22,63,45,1,17/18
Oliver Burke,sct SCO,FWMF,West Brom,20,1997,4.1,6,4,3,2,1,4,12,33.3,8,3,0,3,7,13,3,0,17/18
Jack Butland,eng ENG,GK,Stoke City,24,1993,35,1,1,1,0,0,1,1,100,0,1,0,1,1,2,26,1,17/18
Sam Byram,eng ENG,DFMF,West Ham,23,1993,2.8,9,5,6,3,0,4,9,44.4,5,6,2,4,9,18,16,0,17/18
Willy Caballero,ar ARG,GK,Chelsea,35,1981,3,0,0,0,0,0,0,0,,0,0,0,0,0,0,3,0,17/18
Yohan Cabaye,fr FRA,MF,Crystal Palace,31,1986,26.4,70,44,39,28,3,24,97,24.7,73,47,4,43,79,149,29,4,17/18
Gary Cahill,eng ENG,DF,Chelsea,31,1985,23.2,29,21,15,9,5,10,21,47.6,11,21,14,7,27,56,127,1,17/18
Dominic Calvert-Lewin,eng ENG,FW,Everton,20,1997,20.9,15,8,5,3,7,2,15,13.3,13,13,1,12,10,25,23,1,17/18
Geoff Cameron,us USA,DFMF,Stoke City,32,1985,16.9,34,21,20,12,2,11,27,40.7,16,28,8,20,36,70,68,0,17/18
Tyrese Campbell,eng ENG,FW,Stoke City,17,1999,0.9,2,1,0,2,0,1,1,100,0,1,1,0,1,3,0,0,17/18
Emre Can,de GER,MF,Liverpool,23,1994,23.2,67,54,32,29,6,18,43,41.9,25,32,4,28,28,95,37,1,17/18
Étienne Capoue,fr FRA,MF,Watford,29,1988,17.1,43,26,15,25,3,19,47,40.4,28,21,1,20,43,86,38,0,17/18
Michael Carrick,eng ENG,MF,Manchester Utd,36,1981,1.2,1,1,0,1,0,0,1,0,1,2,0,2,1,2,3,0,17/18
André Carrillo,pe PER,FWMF,Watford,26,1991,17.1,31,24,16,12,3,8,33,24.2,25,7,0,7,15,46,16,0,17/18
Guido Carrillo,ar ARG,FW,Southampton,26,1991,5,5,1,0,3,2,0,1,0,1,4,0,4,0,5,5,0,17/18
Andy Carroll,eng ENG,FW,West Ham,28,1989,8.3,3,3,2,0,1,0,1,0,1,3,2,1,2,5,15,0,17/18
Tom Carroll,eng ENG,MF,Swansea City,25,1992,28.6,53,33,22,23,8,14,53,26.4,39,37,8,29,29,82,18,1,17/18
Craig Cathcart,nir NIR,DF,Watford,28,1989,5.8,8,5,5,3,0,4,5,80,1,8,6,2,3,11,38,0,17/18
Petr Čech,cz CZE,GK,Arsenal,35,1982,33.8,1,1,1,0,0,1,1,100,0,0,0,0,0,1,23,7,17/18
Nacer Chadli,be BEL,FWMF,West Brom,27,1989,2.9,1,0,1,0,0,1,4,25,3,0,0,0,0,1,4,0,17/18
Nathaniel Chalobah,eng ENG,MF,Watford,22,1994,5,9,6,2,6,1,2,5,40,3,6,5,1,6,15,6,0,17/18
Calum Chambers,eng ENG,DF,Arsenal,22,1995,9.6,17,10,10,6,1,5,14,35.7,9,14,11,3,18,35,47,0,17/18
Ben Chilwell,eng ENG,DF,Leicester City,20,1996,20.6,36,26,21,10,5,15,32,46.9,17,31,4,27,28,64,71,3,17/18
Hamza Choudhury,eng ENG,MFDF,Leicester City,19,1997,4.2,9,5,6,3,0,2,10,20,8,12,1,11,8,17,4,0,17/18
Andreas Christensen,dk DEN,DF,Chelsea,21,1996,23.2,26,13,23,3,0,10,15,66.7,5,25,17,8,39,65,109,5,17/18
Lee Chung-yong,kr KOR,FWMF,Crystal Palace,29,1988,1.5,2,0,0,1,1,0,0,,0,3,0,3,2,4,0,1,17/18
Ciaran Clark,ie IRL,DF,Newcastle Utd,27,1989,19.4,25,17,17,8,0,11,21,52.4,10,15,10,5,17,42,144,1,17/18
Tom Cleverley,eng ENG,MF,Watford,27,1989,21.1,48,26,25,16,7,21,52,40.4,31,11,1,10,25,73,21,0,17/18
Sam Clucas,eng ENG,MF,Swansea City,26,1990,22.7,34,19,21,11,2,10,29,34.5,19,31,7,24,29,63,34,1,17/18
Nathaniel Clyne,eng ENG,DFFW,Liverpool,26,1991,1.9,3,1,2,1,0,0,1,0,1,2,1,1,0,3,3,0,17/18
Séamus Coleman,ie IRL,DF,Everton,28,1988,11.5,14,14,9,3,2,6,11,54.5,5,16,12,4,10,24,29,2,17/18
James Collins,wls WAL,DF,West Ham,33,1983,11.7,15,9,11,4,0,8,11,72.7,3,13,10,3,16,31,120,1,17/18
Lewis Cook,eng ENG,MF,Bournemouth,20,1997,24.9,67,35,37,30,0,26,69,37.7,43,33,12,21,35,102,25,2,17/18
Steve Cook,eng ENG,DF,Bournemouth,26,1991,30.7,37,19,28,7,2,19,29,65.5,10,63,45,18,54,91,232,4,17/18
Francis Coquelin,fr FRA,MFDF,Arsenal,26,1991,1.9,5,4,2,3,0,1,3,33.3,2,1,0,1,3,8,2,0,17/18
Jack Cork,eng ENG,MF,Burnley,28,1989,38,60,44,25,27,8,20,62,32.3,42,36,15,21,41,101,86,1,17/18
Thibaut Courtois,be BEL,GK,Chelsea,25,1992,35,0,0,0,0,0,0,0,,0,0,0,0,0,0,8,1,17/18
Philippe Coutinho,br BRA,MFFW,Liverpool,25,1992,12.3,17,14,4,10,3,3,21,14.3,18,10,0,10,10,27,5,1,17/18
Martin Cranie,eng ENG,DF,Huddersfield,30,1986,2,3,2,2,1,0,0,1,0,1,3,3,0,1,4,10,0,17/18
Aaron Cresswell,eng ENG,DF,West Ham,27,1989,34.1,34,21,12,20,2,19,30,63.3,11,42,17,25,44,78,117,1,17/18
Peter Crouch,eng ENG,FW,Stoke City,36,1981,17.4,2,0,0,1,1,0,12,0,12,7,4,3,1,3,31,0,17/18
Josh Cullen,ie IRL,MF,West Ham,21,1996,0.1,0,0,0,0,0,0,1,0,1,1,1,0,2,2,0,0,17/18
Charlie Daniels,eng ENG,DFMF,Bournemouth,30,1986,33.4,48,34,32,12,4,22,41,53.7,19,34,7,27,31,79,114,0,17/18
Danilo,br BRA,DF,Manchester City,26,1991,15,43,29,25,12,6,19,35,54.3,16,15,6,9,19,62,33,0,17/18
Scott Dann,eng ENG,DF,Crystal Palace,30,1987,15.9,10,5,8,2,0,7,17,41.2,10,17,14,3,23,33,98,1,17/18
Karl Darlow,eng ENG,GK,Newcastle Utd,26,1990,10,0,0,0,0,0,0,0,,0,0,0,0,0,0,3,4,17/18
Matteo Darmian,it ITA,DF,Manchester Utd,27,1989,4.9,16,14,7,7,2,6,19,31.6,13,5,3,2,7,23,23,0,17/18
Ben Davies,wls WAL,DF,Tottenham,24,1993,25.8,47,33,13,21,13,25,48,52.1,23,24,5,19,28,75,70,1,17/18
Tom Davies,eng ENG,MF,Everton,19,1998,21.1,30,20,14,11,5,12,54,22.2,42,19,5,14,24,54,21,0,17/18
Steven Davis,nir NIR,MF,Southampton,32,1985,16.9,30,21,10,17,3,11,30,36.7,19,22,6,16,15,45,24,1,17/18
Craig Dawson,eng ENG,DF,West Brom,27,1990,27.9,38,28,25,7,6,13,36,36.1,23,39,26,13,52,90,140,0,17/18
Kevin De Bruyne,be BEL,MF,Manchester City,26,1991,34.1,62,43,23,25,14,23,80,28.8,57,45,2,43,25,87,14,2,17/18
Troy Deeney,eng ENG,FW,Watford,29,1988,20.5,15,11,3,8,4,3,11,27.3,8,14,1,13,5,20,20,0,17/18
Jermain Defoe,eng ENG,FW,Bournemouth,34,1982,12.1,12,9,2,6,4,2,10,20,8,10,0,10,4,16,1,0,17/18
Steven Defour,be BEL,MF,Burnley,29,1988,22.2,33,22,12,18,3,10,46,21.7,36,35,7,28,46,79,25,0,17/18
Damien Delaney,ie IRL,DF,Crystal Palace,36,1981,1.1,2,1,2,0,0,1,1,100,0,5,4,1,3,5,7,0,17/18
Fabian Delph,eng ENG,DF,Manchester City,27,1989,19.3,46,34,21,16,9,18,37,48.6,19,16,0,16,30,76,42,2,17/18
Mousa Dembélé,be BEL,MF,Tottenham,30,1987,20.9,36,24,19,11,6,9,37,24.3,28,20,0,20,33,69,15,0,17/18
Laurent Depoitre,be BEL,FW,Huddersfield,28,1988,20.2,14,8,4,8,2,3,21,14.3,18,15,3,12,11,25,36,0,17/18
Mike van der Hoorn,nl NED,DF,Swansea City,24,1992,21.6,32,22,23,8,1,16,24,66.7,8,24,14,10,39,71,127,0,17/18
Gerard Deulofeu,es ESP,FWMF,Watford,23,1994,4.8,5,3,2,2,1,2,11,18.2,9,0,0,0,4,9,3,1,17/18
Fousseni Diabaté,ml MLI,MFFW,Leicester City,21,1995,6.5,9,6,5,3,1,1,4,25,3,6,0,6,8,17,8,0,17/18
Mohamed Diamé,sn SEN,MF,Newcastle Utd,30,1987,22.7,89,64,33,48,8,16,62,25.8,46,44,7,37,48,137,30,2,17/18
Brahim Díaz,es ESP,FWDF,Manchester City,17,1999,0.6,1,0,1,0,0,0,0,,0,3,0,3,1,2,0,0,17/18
Eric Dier,eng ENG,MFDF,Tottenham,23,1994,31.4,61,43,15,39,7,17,42,40.5,25,32,11,21,48,109,93,7,17/18
Abdoulaye Doucouré,ml MLI,MF,Watford,24,1993,36.9,79,52,28,42,9,27,79,34.2,52,43,10,33,54,133,61,0,17/18
Aleksandar Dragović,at AUT,DF,Leicester City,26,1991,8.5,13,10,13,0,0,7,13,53.8,6,16,8,8,16,29,46,0,17/18
Danny Drinkwater,eng ENG,MF,Chelsea,27,1990,5.9,15,10,6,8,1,3,17,17.6,14,10,2,8,8,23,7,0,17/18
Martin Dúbravka,sk SVK,GK,Newcastle Utd,28,1989,12,0,0,0,0,0,0,0,,0,0,0,0,0,0,3,2,17/18
Shane Duffy,ie IRL,DF,Brighton,25,1992,36.6,31,19,22,9,0,7,20,35,13,66,59,7,50,81,332,5,17/18
Paul Dummett,wls WAL,DF,Newcastle Utd,25,1991,17.8,28,19,21,7,0,13,27,48.1,14,27,10,17,23,51,107,1,17/18
Lewis Dunk,eng ENG,DF,Brighton,25,1991,38,67,33,49,18,0,25,48,52.1,23,73,58,15,71,138,230,2,17/18
Nathan Dyer,eng ENG,MFFW,Swansea City,29,1987,14.5,22,16,8,9,5,6,24,25,18,13,0,13,11,33,3,0,17/18
Ederson,br BRA,GK,Manchester City,23,1993,35.5,1,1,1,0,0,0,0,,0,1,0,1,0,1,15,6,17/18
Tom Edwards,eng ENG,DFMF,Stoke City,18,1999,5.3,15,9,10,5,0,8,8,100,0,5,2,3,5,20,20,0,17/18
Rob Elliot,ie IRL,GK,Newcastle Utd,31,1986,16,0,0,0,0,0,0,1,0,1,0,0,0,0,0,8,0,17/18
Mohamed Elneny,eg EGY,MF,Arsenal,25,1992,9.6,12,6,6,3,3,6,10,60,4,11,0,11,10,22,12,2,17/18
Christian Eriksen,dk DEN,MFFW,Tottenham,25,1992,35.8,51,29,16,30,5,17,59,28.8,42,38,1,37,31,82,21,0,17/18
Jonny Evans,nir NIR,DF,West Brom,29,1988,25.2,29,22,19,8,2,14,33,42.4,19,22,13,9,48,77,131,1,17/18
Patrice Evra,fr FRA,DFMF,West Ham,36,1981,2.5,6,4,5,1,0,6,8,75,2,4,1,3,7,13,6,0,17/18
Łukasz Fabiański,pl POL,GK,Swansea City,32,1985,38,0,0,0,0,0,0,0,,0,0,0,0,0,0,10,2,17/18
Cesc Fàbregas,es ESP,MF,Chelsea,30,1987,25.6,68,49,30,29,9,18,69,26.1,51,25,4,21,22,90,26,2,17/18
Marouane Fellaini,be BEL,MF,Manchester Utd,29,1987,7.6,15,8,6,8,1,2,11,18.2,9,12,3,9,14,29,19,1,17/18
Kiko Femenía,es ESP,DFFW,Watford,26,1991,19,36,28,22,11,3,14,27,51.9,13,15,2,13,34,70,31,1,17/18
Leroy Fer,nl NED,MF,Swansea City,27,1990,15.5,44,32,18,21,5,13,30,43.3,17,18,4,14,12,56,24,3,17/18
Edimilson Fernandes,ch SUI,MFDF,West Ham,21,1996,9.4,17,9,10,7,0,9,21,42.9,12,13,1,12,16,33,8,0,17/18
Federico Fernández,ar ARG,DF,Swansea City,28,1989,29.7,40,29,30,6,4,20,30,66.7,10,35,27,8,38,78,201,1,17/18
Fernandinho,br BRA,MF,Manchester City,32,1985,32,62,35,22,28,12,24,65,36.9,41,38,6,32,47,109,68,2,17/18
Sam Field,eng ENG,MF,West Brom,19,1998,6,14,11,8,4,2,3,10,30,7,6,1,5,11,25,8,0,17/18
Roberto Firmino,br BRA,FW,Liverpool,25,1991,30.7,65,50,9,36,20,8,58,13.8,50,40,2,38,18,83,10,0,17/18
Darren Fletcher,sct SCO,MF,Stoke City,33,1984,24.7,47,26,23,20,4,15,55,27.3,40,13,3,10,26,73,33,3,17/18
Phil Foden,eng ENG,MFFW,Manchester City,17,2000,0.5,1,1,0,1,0,0,1,0,1,0,0,0,0,1,1,0,17/18
José Fonte,pt POR,DF,West Ham,33,1983,7.6,11,6,5,6,0,2,6,33.3,4,12,9,3,14,25,37,1,17/18
Fraser Forster,eng ENG,GK,Southampton,29,1988,20,0,0,0,0,0,0,0,,0,0,0,0,0,0,7,4,17/18
Ben Foster,eng ENG,GK,West Brom,34,1983,37,1,0,1,0,0,0,7,0,7,0,0,0,1,2,12,1,17/18
Timothy Fosu-Mensah,nl NED,DF,Crystal Palace,19,1998,17.7,42,33,33,8,1,21,34,61.8,13,17,9,8,31,73,74,1,17/18
Simon Francis,eng ENG,DF,Bournemouth,32,1985,30.1,49,34,26,16,7,24,43,55.8,19,29,18,11,49,98,194,4,17/18
Ryan Fraser,sct SCO,MFDF,Bournemouth,23,1994,22.3,11,8,7,2,2,7,20,35,13,20,4,16,17,28,34,0,17/18
Christian Fuchs,at AUT,DF,Leicester City,31,1986,21.3,41,27,25,12,4,14,40,35,26,23,3,20,58,99,86,0,17/18
Jay Fulton,sct SCO,MF,Swansea City,23,1994,0.2,0,0,0,0,0,0,0,,0,0,0,0,0,0,1,0,17/18
Ramiro Funes Mori,ar ARG,DF,Everton,26,1991,1.3,0,0,0,0,0,0,0,,0,1,1,0,3,3,14,0,17/18
Manolo Gabbiadini,it ITA,FW,Southampton,25,1991,12,3,2,0,2,1,1,15,6.7,14,3,0,3,4,7,6,0,17/18
Jesús Gámez,es ESP,DF,Newcastle Utd,32,1985,1.1,4,2,1,0,3,1,3,33.3,2,2,0,2,2,6,5,0,17/18
Idrissa Gana Gueye,sn SEN,MF,Everton,27,1989,30.6,117,93,65,41,11,35,86,40.7,51,59,9,50,62,179,48,1,17/18
Dwight Gayle,eng ENG,FW,Newcastle Utd,26,1990,21.8,12,10,2,8,2,1,21,4.8,20,16,2,14,6,18,17,0,17/18
Paulo Gazzaniga,ar ARG,GK,Tottenham,25,1992,1,0,0,0,0,0,0,1,0,1,0,0,0,0,0,0,0,17/18
David de Gea,es ESP,GK,Manchester Utd,26,1990,37,0,0,0,0,0,0,1,0,1,1,0,1,0,0,9,3,17/18
Kieran Gibbs,eng ENG,DF,West Brom,27,1989,31.4,41,24,27,10,4,16,30,53.3,14,32,12,20,48,89,102,0,17/18
Olivier Giroud,fr FRA,FW,Arsenal,30,1986,4.3,5,4,1,2,2,1,5,20,4,1,0,1,1,6,4,0,17/18
Olivier Giroud,fr FRA,FW,Chelsea,30,1986,6.8,4,3,1,2,1,1,3,33.3,2,0,0,0,1,5,5,0,17/18
Connor Goldson,eng ENG,DF,Brighton,24,1992,2.2,2,2,1,1,0,1,4,25,3,3,3,0,1,3,9,0,17/18
Heurelho Gomes,br BRA,GK,Watford,36,1981,23.6,0,0,0,0,0,0,1,0,1,1,0,1,2,2,15,3,17/18
Joe Gomez,eng ENG,DF,Liverpool,20,1997,21.1,58,45,32,23,3,21,40,52.5,19,19,8,11,34,92,57,1,17/18
Dan Gosling,eng ENG,MF,Bournemouth,27,1990,21.6,50,25,19,26,5,19,68,27.9,49,36,8,28,25,75,35,0,17/18
Lee Grant,eng ENG,GK,Stoke City,34,1983,3,1,1,1,0,0,1,1,100,0,0,0,0,0,1,0,0,17/18
Andre Gray,jm JAM,FW,Watford,26,1991,16.6,2,1,0,1,1,0,3,0,3,11,0,11,4,6,3,0,17/18
Demarai Gray,eng ENG,MFFW,Leicester City,21,1996,18.9,17,15,6,9,2,4,23,17.4,19,27,0,27,11,28,14,1,17/18
Pascal Groß,de GER,FWMF,Brighton,26,1991,32.5,36,24,18,16,2,10,67,14.9,57,31,5,26,14,50,20,0,17/18
Marko Grujić,rs SRB,MFDF,Liverpool,21,1996,0.2,2,2,0,1,1,2,2,100,0,0,0,0,0,2,0,0,17/18
İlkay Gündoğan,de GER,MF,Manchester City,26,1990,16.9,27,15,8,14,5,9,37,24.3,28,14,1,13,16,43,12,0,17/18
Florent Hadergjonaj,xk KVX,DFMF,Huddersfield,23,1994,18.6,21,16,7,10,4,12,30,40,18,22,10,12,17,38,45,0,17/18
Massadio Haïdara,ml MLI,FW,Newcastle Utd,24,1992,0,0,0,0,0,0,0,0,,0,0,0,0,0,0,0,0,17/18
Ben Hamer,eng ENG,GK,Leicester City,29,1987,3.1,0,0,0,0,0,0,1,0,1,0,0,0,0,0,3,1,17/18
Rekeem Harper,eng ENG,MF,West Brom,17,2000,0.2,1,1,0,1,0,0,0,,0,0,0,0,0,1,0,0,17/18
Joe Hart,eng ENG,GK,West Ham,30,1987,19,1,1,1,0,0,1,2,50,1,1,0,1,0,1,2,4,17/18
Isaac Hayden,eng ENG,MF,Newcastle Utd,22,1995,15.3,40,23,23,16,1,12,34,35.3,22,21,6,15,23,63,43,0,17/18
Eden Hazard,be BEL,FWMF,Chelsea,26,1991,26.9,6,3,2,3,1,3,21,14.3,18,11,0,11,3,9,0,0,17/18
Tom Heaton,eng ENG,GK,Burnley,31,1986,3.4,0,0,0,0,0,0,0,,0,0,0,0,0,0,0,0,17/18
Michael Hefele,de GER,DF,Huddersfield,26,1990,0.4,0,0,0,0,0,0,0,,0,0,0,0,1,1,5,0,17/18
Ahmed Hegazi,eg EGY,DF,West Brom,26,1991,37.6,58,38,46,12,0,26,50,52,24,55,37,18,60,118,278,2,17/18
Tomer Hemed,il ISR,FW,Brighton,30,1987,9.4,7,5,3,4,0,2,10,20,8,10,1,9,2,9,12,0,17/18
Jordan Henderson,eng ENG,MF,Liverpool,27,1990,24.1,51,33,13,32,6,18,52,34.6,34,33,2,31,31,82,27,0,17/18
Jeff Hendrick,ie IRL,FWMF,Burnley,25,1992,25.9,16,10,4,10,2,3,17,17.6,14,11,2,9,8,24,21,1,17/18
Wayne Hennessey,wls WAL,GK,Crystal Palace,30,1987,27,0,0,0,0,0,0,0,,0,1,0,1,2,2,5,1,17/18
Javier Hernández,mx MEX,FW,West Ham,29,1988,17.2,11,7,2,7,2,3,14,21.4,11,6,1,5,6,17,1,0,17/18
Ander Herrera,es ESP,MF,Manchester Utd,27,1989,14.1,56,29,32,20,4,20,69,29,49,33,6,27,34,90,22,2,17/18
Son Heung-min,kr KOR,FW,Tottenham,25,1992,25.7,17,10,2,12,3,2,28,7.1,26,18,0,18,10,27,12,0,17/18
Wesley Hoedt,nl NED,DF,Southampton,23,1994,28,60,51,48,12,0,36,61,59,25,32,17,15,40,100,177,2,17/18
Jonathan Hogg,eng ENG,MF,Huddersfield,28,1988,26.6,93,64,29,59,5,26,89,29.2,63,51,12,39,69,162,48,0,17/18
Rob Holding,eng ENG,DF,Arsenal,21,1995,9.1,19,14,13,5,1,4,12,33.3,8,16,10,6,21,40,40,2,17/18
José Holebas,gr GRE,DF,Watford,33,1984,26.5,51,31,34,14,3,18,44,40.9,26,24,8,16,29,80,95,2,17/18
Mason Holgate,eng ENG,DF,Everton,20,1996,13.2,23,16,15,7,1,10,21,47.6,11,12,9,3,23,46,86,2,17/18
Callum Hudson-Odoi,eng ENG,FWDF,Chelsea,16,2000,0.3,0,0,0,0,0,0,0,,0,0,0,0,0,0,0,0,17/18
Will Hughes,eng ENG,MF,Watford,22,1995,11,34,18,7,18,9,9,19,47.4,10,16,1,15,15,49,6,0,17/18
Jordan Hugill,eng ENG,FW,West Ham,25,1992,0.3,0,0,0,0,0,0,1,0,1,0,0,0,0,0,0,0,17/18
Uwe Hünemeier,de GER,DF,Brighton,31,1986,0.2,0,0,0,0,0,0,0,,0,0,0,0,0,0,4,0,17/18
Emerson Hyndman,us USA,MF,Bournemouth,21,1996,0.6,0,0,0,0,0,0,1,0,1,2,0,2,1,1,1,0,17/18
Pierre Højbjerg,dk DEN,MF,Southampton,21,1995,18.6,45,29,24,18,3,13,56,23.2,43,30,3,27,37,82,26,1,17/18
Jordon Ibe,eng ENG,MFFW,Bournemouth,21,1995,22.2,14,12,7,5,2,6,22,27.3,16,5,0,5,10,24,11,0,17/18
Vicente Iborra,es ESP,MF,Leicester City,29,1988,15.7,23,18,13,10,0,9,36,25,27,25,11,14,19,42,49,1,17/18
Zlatan Ibrahimović,se SWE,MFFW,Manchester Utd,35,1981,1.2,2,1,1,0,1,0,1,0,1,0,0,0,0,2,1,0,17/18
Kelechi Iheanacho,ng NGA,FWMF,Leicester City,20,1996,9.2,9,6,3,5,1,3,20,15,17,10,2,8,3,12,4,0,17/18
Tom Ince,eng ENG,MFFW,Huddersfield,25,1992,27.2,35,27,14,16,5,10,29,34.5,19,20,0,20,12,47,12,0,17/18
Danny Ings,eng ENG,FW,Liverpool,25,1992,3,5,3,1,3,1,0,0,,0,4,0,4,2,7,1,0,17/18
Stephen Ireland,ie IRL,MFFW,Stoke City,30,1986,1.5,3,1,2,1,0,1,5,20,4,4,2,2,1,4,1,0,17/18
Alex Iwobi,ng NGA,MFFW,Arsenal,21,1996,20.3,19,15,8,8,3,5,18,27.8,13,19,1,18,7,26,10,1,17/18
José Izquierdo,co COL,MFFW,Brighton,25,1992,22,23,15,12,9,2,7,19,36.8,12,6,0,6,16,39,34,0,17/18
Phil Jagielka,eng ENG,DF,Everton,34,1982,22.9,33,23,24,9,0,8,21,38.1,13,30,20,10,39,72,179,1,17/18
Eldin Jakupović,ch SUI,GK,Leicester City,32,1984,2,0,0,0,0,0,0,0,,0,0,0,0,0,0,4,0,17/18
Matty James,eng ENG,MF,Leicester City,26,1991,11,19,10,7,11,1,2,10,20,8,14,2,12,17,36,25,0,17/18
Daryl Janmaat,nl NED,DF,Watford,28,1989,20.2,46,31,29,10,7,22,52,42.3,30,16,5,11,33,79,61,0,17/18
Vincent Janssen,nl NED,DF,Tottenham,23,1994,0,0,0,0,0,0,0,0,,0,0,0,0,0,0,0,0,17/18
Jesé,es ESP,FWMF,Stoke City,24,1993,6.8,10,7,3,5,2,3,13,23.1,10,5,0,5,0,10,3,0,17/18
Gabriel Jesus,br BRA,FW,Manchester City,20,1997,18.5,23,15,6,10,7,3,22,13.6,19,16,0,16,8,31,6,0,17/18
Glen Johnson,eng ENG,DF,Stoke City,32,1984,6.1,7,5,5,2,0,3,12,25,9,7,2,5,10,17,23,0,17/18
Phil Jones,eng ENG,DF,Manchester Utd,25,1992,21.9,25,18,20,5,0,9,20,45,11,25,17,8,41,66,133,2,17/18
Joselu,es ESP,FW,Newcastle Utd,27,1990,19,22,17,10,11,1,7,34,20.6,27,25,2,23,11,33,39,0,17/18
Mathias Jørgensen,dk DEN,DF,Huddersfield,27,1990,38,55,36,40,13,2,19,45,42.2,26,49,20,29,76,131,249,5,17/18
Christian Kabasele,be BEL,DF,Watford,26,1991,25.9,42,25,28,14,0,21,36,58.3,15,37,23,14,34,76,185,0,17/18
Younès Kaboul,fr FRA,DF,Watford,31,1986,1.7,3,2,0,3,0,0,0,,0,4,2,2,2,5,15,0,17/18
Elias Kachunga,cd COD,FWMF,Huddersfield,25,1992,14.8,30,26,13,12,5,8,19,42.1,11,14,1,13,2,32,9,0,17/18
Sullay Kaikai,sl SLE,MF,Crystal Palace,21,1995,0.2,1,0,0,1,0,0,0,,0,1,0,1,0,1,1,0,17/18
Harry Kane,eng ENG,FW,Tottenham,24,1993,34.2,17,12,2,8,7,4,15,26.7,11,15,4,11,5,22,19,0,17/18
N'Golo Kanté,fr FRA,MF,Chelsea,26,1991,33.3,113,77,55,52,6,33,92,35.9,59,40,4,36,85,198,29,3,17/18
Loris Karius,de GER,GK,Liverpool,24,1993,19,0,0,0,0,0,0,0,,0,0,0,0,1,1,4,0,17/18
Orestis Karnezis,gr GRE,GK,Watford,32,1985,14.4,0,0,0,0,0,0,2,0,2,0,0,0,1,1,3,3,17/18
Beram Kayal,il ISR,MF,Brighton,29,1988,8.3,18,11,10,7,1,6,26,23.1,20,11,4,7,12,30,9,0,17/18
Michael Keane,eng ENG,DF,Everton,24,1993,28.4,33,25,26,5,2,19,43,44.2,24,39,28,11,53,86,214,0,17/18
Martin Kelly,eng ENG,DF,Crystal Palace,27,1990,13.3,19,13,15,4,0,14,26,53.8,12,16,11,5,9,28,67,3,17/18
Kenedy,br BRA,MFDF,Newcastle Utd,21,1996,11.4,31,17,16,13,2,12,35,34.3,23,12,1,11,14,45,11,0,17/18
Jonjoe Kenny,eng ENG,DF,Everton,20,1997,17.7,41,33,28,10,3,20,32,62.5,12,17,7,10,28,69,95,0,17/18
Andy King,wls WAL,MF,Leicester City,28,1988,6,8,5,0,5,3,0,3,0,3,4,2,2,5,13,13,0,17/18
Andy King,wls WAL,MF,Swansea City,28,1988,7.9,18,11,10,8,0,5,14,35.7,9,7,0,7,6,24,14,1,17/18
Joshua King,no NOR,FWMF,Bournemouth,25,1992,27.3,36,26,11,17,8,4,27,14.8,23,23,3,20,4,40,14,1,17/18
Davy Klaassen,nl NED,MFFW,Everton,24,1993,2.8,3,1,1,2,0,2,6,33.3,4,2,1,1,1,4,2,0,17/18
Ragnar Klavan,ee EST,DF,Liverpool,31,1985,16.1,14,10,6,7,1,6,12,50,6,11,5,6,15,29,85,1,17/18
Anthony Knockaert,fr FRA,MFFW,Brighton,25,1991,26.9,39,26,25,11,3,16,55,29.1,39,29,3,26,23,62,16,0,17/18
Sead Kolašinac,ba BIH,DF,Arsenal,24,1993,23.9,49,37,28,13,8,20,39,51.3,19,15,3,12,26,75,56,0,17/18
Vincent Kompany,be BEL,DF,Manchester City,31,1986,15.5,20,11,14,5,1,13,19,68.4,6,10,8,2,16,36,73,1,17/18
Terence Kongolo,nl NED,DF,Huddersfield,23,1994,11.7,33,20,19,13,1,14,22,63.6,8,12,6,6,32,65,71,0,17/18
Laurent Koscielny,fr FRA,DF,Arsenal,31,1985,24.7,43,21,27,12,4,19,33,57.6,14,28,15,13,54,97,138,3,17/18
Cheikhou Kouyaté,sn SEN,MF,West Ham,27,1989,31.1,71,49,43,26,2,23,62,37.1,39,31,11,20,32,103,56,1,17/18
Bojan Krkić,es ESP,MF,Stoke City,26,1990,0.8,0,0,0,0,0,0,1,0,1,1,0,1,0,0,0,0,17/18
Grzegorz Krychowiak,pl POL,MF,West Brom,27,1990,18.2,39,24,18,17,4,12,49,24.5,37,23,5,18,45,84,23,0,17/18
Rajiv van La Parra,nl NED,FWMF,Huddersfield,26,1991,23.7,41,29,18,15,8,12,41,29.3,29,27,1,26,21,62,8,1,17/18
Alexandre Lacazette,fr FRA,FW,Arsenal,26,1991,24.5,24,17,6,11,7,4,27,14.8,23,19,3,16,7,31,5,0,17/18
Freddie Ladapo,eng ENG,FW,Crystal Palace,24,1993,0.2,0,0,0,0,0,0,0,,0,0,0,0,0,0,0,0,17/18
Adam Lallana,eng ENG,MFFW,Liverpool,29,1988,3.4,3,1,3,0,0,2,10,20,8,3,0,3,1,4,1,0,17/18
Érik Lamela,ar ARG,FWMF,Tottenham,25,1992,9.4,23,13,9,7,7,3,20,15,17,11,1,10,7,30,5,0,17/18
Manuel Lanzini,ar ARG,MFFW,West Ham,24,1993,22.7,20,11,6,11,3,2,34,5.9,32,7,1,6,30,50,5,2,17/18
Aymeric Laporte,es ESP,DF,Manchester City,23,1994,9,8,7,6,2,0,3,8,37.5,5,2,1,1,11,19,27,0,17/18
Jamaal Lascelles,eng ENG,DF,Newcastle Utd,23,1993,32.5,31,19,19,11,1,12,19,63.2,7,33,24,9,28,59,232,1,17/18
Florian Lejeune,fr FRA,DF,Newcastle Utd,26,1991,23.4,34,20,26,8,0,14,30,46.7,16,21,15,6,46,80,154,0,17/18
Mario Lemina,ga GAB,MF,Southampton,23,1993,19.1,55,40,21,29,5,12,30,40,18,18,6,12,36,91,36,4,17/18
Aaron Lennon,eng ENG,MF,Burnley,30,1987,12.4,20,14,5,14,1,2,20,10,18,20,5,15,8,28,18,0,17/18
Aaron Lennon,eng ENG,FWMF,Everton,30,1987,8.8,17,10,10,5,2,5,21,23.8,16,13,1,12,11,28,9,0,17/18
Victor Lindelöf,se SWE,DF,Manchester Utd,23,1994,14.3,17,11,10,6,1,9,14,64.3,5,15,11,4,13,30,67,1,17/18
Jesse Lingard,eng ENG,MFFW,Manchester Utd,24,1992,20.2,30,21,10,13,7,5,27,18.5,22,18,3,15,9,39,13,0,17/18
Jake Livermore,eng ENG,MF,West Brom,27,1989,29.7,72,41,27,35,10,24,64,37.5,40,44,9,35,26,98,36,2,17/18
Fernando Llorente,es ESP,FWMF,Tottenham,32,1985,2.6,6,3,1,2,3,1,2,50,1,0,0,0,0,6,6,0,17/18
Hugo Lloris,fr FRA,GK,Tottenham,30,1986,36,1,1,1,0,0,1,4,25,3,0,0,0,2,3,34,8,17/18
Jürgen Locadia,nl NED,FWMF,Brighton,23,1993,2.5,1,0,0,1,0,0,1,0,1,0,0,0,1,2,1,1,17/18
Ruben Loftus-Cheek,eng ENG,MF,Crystal Palace,21,1996,20.8,21,15,7,13,1,7,30,23.3,23,19,2,17,22,43,31,0,17/18
Joe Lolley,eng ENG,FWMF,Huddersfield,24,1992,2.5,2,0,1,1,0,0,2,0,2,0,0,0,3,5,2,1,17/18
Kevin Long,ie IRL,DF,Burnley,26,1990,16,32,23,28,4,0,16,26,61.5,10,25,14,11,19,51,129,1,17/18
Shane Long,ie IRL,FW,Southampton,30,1987,17.6,25,20,1,19,5,10,30,33.3,20,14,2,12,12,37,29,0,17/18
Ademola Lookman,ng NGA,FWMF,Everton,19,1997,1.8,1,1,0,1,0,0,2,0,2,2,0,2,1,2,3,0,17/18
Jonas Lössl,dk DEN,GK,Huddersfield,28,1989,38,1,0,1,0,0,1,5,20,4,0,0,0,4,5,13,6,17/18
Dejan Lovren,hr CRO,DF,Liverpool,28,1989,23.6,26,17,14,11,1,12,22,54.5,10,26,15,11,38,64,146,2,17/18
Chris Löwe,de GER,DF,Huddersfield,28,1989,17.6,43,29,26,15,2,20,44,45.5,24,21,8,13,34,77,65,3,17/18
Matthew Lowton,eng ENG,DF,Burnley,28,1989,25.5,55,34,26,27,2,28,60,46.7,32,35,15,20,39,94,141,2,17/18
David Luiz,br BRA,DFMF,Chelsea,30,1987,9.3,18,11,13,4,1,11,21,52.4,10,9,5,4,24,42,45,2,17/18
Romelu Lukaku,be BEL,FW,Manchester Utd,24,1993,31.9,7,4,1,3,3,0,13,0,13,9,2,7,3,10,22,2,17/18
Dodi Lukebakio,be BEL,MFFW,Watford,19,1997,0.2,1,0,1,0,0,0,0,,0,0,0,0,0,1,0,0,17/18
Levi Lumeka,eng ENG,FW,Crystal Palace,18,1998,0.3,1,1,1,0,0,0,0,,0,0,0,0,1,2,0,0,17/18
Harry Maguire,eng ENG,DF,Leicester City,24,1993,38,63,46,47,15,1,26,43,60.5,17,35,28,7,48,111,181,1,17/18
Riyad Mahrez,dz ALG,MFFW,Leicester City,26,1991,32.8,39,27,16,17,6,10,63,15.9,53,32,1,31,18,57,15,0,17/18
Ainsley Maitland-Niles,eng ENG,DFMF,Arsenal,19,1997,10.2,25,17,12,7,6,14,31,45.2,17,15,1,14,12,37,35,2,17/18
Scott Malone,eng ENG,DF,Huddersfield,26,1991,12.4,39,29,27,10,2,17,24,70.8,7,12,2,10,26,65,43,2,17/18
Sadio Mané,sn SEN,FW,Liverpool,25,1992,24.3,28,20,8,11,9,3,23,13,20,20,0,20,9,37,8,0,17/18
Eliaquim Mangala,fr FRA,DF,Manchester City,26,1991,5.4,5,3,5,0,0,1,3,33.3,2,4,3,1,2,7,24,0,17/18
Eliaquim Mangala,fr FRA,DF,Everton,26,1991,1.5,2,1,1,1,0,0,0,,0,0,0,0,1,3,4,1,17/18
Javier Manquillo,es ESP,DF,Newcastle Utd,23,1994,19.5,36,22,25,8,3,15,30,50,15,25,6,19,18,54,65,0,17/18
Solly March,eng ENG,MFFW,Brighton,23,1994,20.6,54,41,34,14,6,22,54,40.7,32,27,3,24,13,67,49,0,17/18
Adrian Mariappa,jm JAM,DF,Watford,30,1986,24.6,45,26,33,12,0,14,34,41.2,20,25,16,9,45,90,133,4,17/18
João Mário,pt POR,MF,West Ham,24,1993,11.4,14,11,6,5,3,6,19,31.6,13,7,0,7,8,22,4,1,17/18
Anthony Martial,fr FRA,FW,Manchester Utd,21,1995,17.6,15,13,9,2,4,3,12,25,9,5,1,4,3,18,7,0,17/18
Cuco Martina,cw CUW,DF,Everton,27,1989,20.3,61,35,38,15,8,27,46,58.7,19,17,4,13,42,103,130,2,17/18
Bruno Martins Indi,nl NED,DF,Stoke City,25,1992,13.8,21,12,18,3,0,10,19,52.6,9,16,11,5,21,42,77,1,17/18
Arthur Masuaku,cd COD,DF,West Ham,23,1993,20.8,58,37,36,16,6,25,58,43.1,33,25,2,23,26,84,38,1,17/18
Juan Mata,es ESP,FW,Manchester Utd,29,1988,21.4,18,13,4,12,2,2,24,8.3,22,10,0,10,15,33,10,1,17/18
Nemanja Matić,rs SRB,MF,Manchester Utd,28,1988,34.6,70,42,32,34,4,23,71,32.4,48,50,13,37,64,134,62,2,17/18
Joël Matip,cm CMR,DF,Liverpool,25,1991,22.2,35,24,23,11,1,12,24,50,12,26,15,11,35,70,101,1,17/18
Konstantinos Mavropanos,gr GRE,DF,Arsenal,19,1997,2.2,1,1,1,0,0,1,2,50,1,4,3,1,6,7,11,1,17/18
Alfie Mawson,eng ENG,DF,Swansea City,23,1994,38,32,22,24,8,0,16,27,59.3,11,41,32,9,35,67,229,5,17/18
Eric Maxim Choupo-Moting,cm CMR,FWMF,Stoke City,28,1989,25.7,42,30,21,16,5,9,32,28.1,23,31,3,28,23,65,29,1,17/18
Chancel Mbemba,cd COD,DF,Newcastle Utd,22,1994,7.5,16,12,13,3,0,10,17,58.8,7,7,3,4,15,31,44,1,17/18
James McArthur,sct SCO,MF,Crystal Palace,29,1987,27,58,44,28,27,3,23,61,37.7,38,39,2,37,36,94,44,2,17/18
Gareth McAuley,nir NIR,DF,West Brom,37,1979,5.1,8,7,6,2,0,3,7,42.9,4,7,4,3,11,19,16,0,17/18
Oliver McBurnie,sct SCO,FWMF,Swansea City,21,1996,3.1,4,3,0,2,2,1,3,33.3,2,2,0,2,0,4,3,0,17/18
Alex McCarthy,eng ENG,GK,Southampton,27,1989,18,0,0,0,0,0,0,0,,0,0,0,0,1,1,8,0,17/18
James McCarthy,ie IRL,MF,Everton,26,1990,2.3,9,9,3,4,2,1,5,20,4,9,2,7,5,14,3,1,17/18
James McClean,ie IRL,MFFW,West Brom,28,1989,15.6,40,28,23,14,3,10,55,18.2,45,18,4,14,20,60,22,0,17/18
Sam McQueen,eng ENG,DFMF,Southampton,22,1995,1.6,4,4,4,0,0,2,4,50,2,2,1,1,3,7,3,0,17/18
Scott McTominay,sct SCO,MF,Manchester Utd,20,1996,7,11,9,4,5,2,5,13,38.5,8,3,0,3,13,24,9,0,17/18
Ben Mee,eng ENG,DF,Burnley,27,1989,29,33,20,22,11,0,16,29,55.2,13,51,42,9,33,66,217,1,17/18
Benjamin Mendy,fr FRA,DFFW,Manchester City,23,1994,4,5,4,2,0,3,5,7,71.4,2,5,0,5,8,13,9,0,17/18
Mikel Merino,es ESP,MF,Newcastle Utd,21,1996,15,56,40,21,32,3,17,56,30.4,39,36,8,28,34,90,25,0,17/18
Per Mertesacker,de GER,DF,Arsenal,32,1984,4.1,2,2,0,2,0,0,1,0,1,4,3,1,6,8,22,2,17/18
Roque Mesa,es ESP,MF,Swansea City,28,1989,8.4,20,13,8,8,4,10,37,27,27,6,0,6,13,33,8,1,17/18
Simon Mignolet,be BEL,GK,Liverpool,29,1988,19,2,1,2,0,0,1,3,33.3,2,0,0,0,0,2,5,3,17/18
Luka Milivojević,rs SRB,MF,Crystal Palace,26,1991,34.2,85,52,40,37,8,31,86,36,55,50,12,38,71,156,81,3,17/18
James Milner,eng ENG,MF,Liverpool,31,1986,19.7,58,45,18,32,8,15,39,38.5,24,33,5,28,21,79,23,0,17/18
Tyrone Mings,eng ENG,DF,Bournemouth,24,1993,2.2,1,1,1,0,0,0,0,,0,2,2,0,6,7,13,1,17/18
Kevin Mirallas,be BEL,FWMF,Everton,29,1987,1.5,4,3,1,2,1,0,1,0,1,0,0,0,0,4,3,0,17/18
Aleksandar Mitrović,rs SRB,FW,Newcastle Utd,22,1994,1.1,1,1,0,1,0,0,1,0,1,1,0,1,0,1,2,0,17/18
Henrikh Mkhitaryan,am ARM,FWMF,Arsenal,28,1989,8.8,18,13,9,7,2,5,21,23.8,16,16,2,14,8,26,7,0,17/18
Henrikh Mkhitaryan,am ARM,MFFW,Manchester Utd,28,1989,10.2,15,11,4,7,4,5,25,20,20,8,0,8,7,22,3,0,17/18
Nacho Monreal,es ESP,DF,Arsenal,31,1986,24.9,54,32,19,29,6,21,48,43.8,27,26,7,19,56,110,83,2,17/18
Aaron Mooy,au AUS,MF,Huddersfield,26,1990,34.1,102,60,39,51,12,23,55,41.8,32,39,5,34,38,140,52,0,17/18
Álvaro Morata,es ESP,FW,Chelsea,24,1992,22.9,13,8,0,7,6,1,21,4.8,20,17,4,13,6,19,20,0,17/18
Alberto Moreno,es ESP,DF,Liverpool,25,1992,14.1,35,26,21,12,2,13,29,44.8,16,19,2,17,12,47,44,0,17/18
Wes Morgan,jm JAM,DF,Leicester City,33,1984,31.3,35,25,26,8,1,12,18,66.7,6,41,27,14,31,66,146,1,17/18
James Morrison,sct SCO,MF,West Brom,31,1986,2.3,2,1,0,2,0,1,4,25,3,1,1,0,1,3,1,0,17/18
Victor Moses,ng NGA,DFMF,Chelsea,26,1990,23.4,37,29,21,13,3,14,24,58.3,10,29,4,25,15,52,39,2,17/18
Steve Mounié,bj BEN,FW,Huddersfield,22,1994,20.6,11,8,2,4,5,0,19,0,19,23,3,20,7,18,30,0,17/18
Lucas Moura,br BRA,FWMF,Tottenham,24,1992,2.3,4,2,3,0,1,1,3,33.3,2,2,0,2,2,6,2,0,17/18
Lys Mousset,fr FRA,FWMF,Bournemouth,21,1996,6.6,9,5,6,3,0,0,8,0,8,5,2,3,3,12,9,0,17/18
Jacob Murphy,eng ENG,MFFW,Newcastle Utd,22,1995,12.8,13,10,5,4,4,7,27,25.9,20,16,0,16,6,19,13,2,17/18
Jamie Murphy,sct SCO,MF,Brighton,27,1989,1.9,2,2,2,0,0,2,4,50,2,0,0,0,1,3,3,0,17/18
Glenn Murray,eng ENG,FW,Brighton,33,1983,24.4,18,12,4,11,3,2,18,11.1,16,16,4,12,5,23,27,0,17/18
Charly Musonda Jr.,be BEL,FW,Chelsea,20,1996,0.4,1,0,0,0,1,1,1,100,0,0,0,0,0,1,0,0,17/18
Shkodran Mustafi,de GER,DF,Arsenal,25,1992,25.3,64,46,42,18,4,28,54,51.9,26,23,15,8,57,121,175,2,17/18
Boaz Myhill,wls WAL,GK,West Brom,34,1982,1,0,0,0,0,0,0,0,,0,0,0,0,0,0,1,0,17/18
Georges-Kévin N'Koudou,cm CMR,MF,Tottenham,22,1995,0,0,0,0,0,0,0,0,,0,0,0,0,0,0,1,0,17/18
Georges-Kévin N'Koudou,cm CMR,MFFW,Burnley,22,1995,2.5,7,6,5,1,1,3,8,37.5,5,4,0,4,1,8,1,0,17/18
Luciano Narsingh,nl NED,FWMF,Swansea City,26,1990,6.9,7,5,1,5,1,2,7,28.6,5,7,0,7,3,10,3,0,17/18
Kyle Naughton,eng ENG,DF,Swansea City,28,1988,33.7,92,60,49,35,8,54,100,54,46,60,13,47,60,152,144,4,17/18
Badou Ndiaye,sn SEN,MF,Stoke City,26,1990,12.6,53,28,22,25,6,16,41,39,25,21,9,12,13,66,18,0,17/18
Wilfred Ndidi,ng NGA,MF,Leicester City,20,1996,32.2,138,89,68,65,5,45,119,37.8,74,67,10,57,51,189,103,2,17/18
Reiss Nelson,eng ENG,FWMF,Arsenal,17,1999,1.6,4,3,1,1,2,0,0,,0,4,0,4,3,7,0,0,17/18
Julien Ngoy,be BEL,MF,Stoke City,19,1997,0.2,1,1,0,1,0,1,2,50,1,0,0,0,0,1,0,0,17/18
Oumar Niasse,sn SEN,FW,Everton,27,1990,12.1,10,6,2,5,3,4,19,21.1,15,3,2,1,2,12,6,0,17/18
Eddie Nketiah,eng ENG,FW,Arsenal,18,1999,0.2,1,1,0,1,0,0,0,,0,0,0,0,0,1,0,0,17/18
Lukas Nmecha,de GER,FW,Manchester City,18,1998,0.2,0,0,0,0,0,0,0,,0,0,0,0,0,0,0,0,17/18
Mark Noble,eng ENG,MF,West Ham,30,1987,26.7,61,36,32,22,7,16,76,21.1,60,28,10,18,47,108,32,1,17/18
Allan Nyom,cm CMR,DF,West Brom,29,1988,25.7,64,39,43,17,4,28,43,65.1,15,20,9,11,27,91,93,0,17/18
Aiden O'Neill,au AUS,MF,Burnley,19,1998,0,,,,,,,,,,,,,,,,,17/18
Michael Obafemi,ie IRL,FW,Southampton,17,2000,0.1,0,0,0,0,0,0,0,,0,0,0,0,0,0,0,0,17/18
Pedro Obiang,gq EQG,MF,West Ham,25,1992,17.4,53,34,20,29,4,17,51,33.3,34,37,16,21,24,77,27,1,17/18
Angelo Ogbonna,it ITA,DF,West Ham,29,1988,32,30,24,18,10,2,8,18,44.4,10,40,27,13,58,88,197,1,17/18
Stefano Okaka,it ITA,FW,Watford,27,1989,5,6,4,0,6,0,3,6,50,3,3,0,3,0,6,0,0,17/18
Shinji Okazaki,jp JPN,FWMF,Leicester City,31,1986,14.7,25,16,3,18,4,4,28,14.3,24,15,1,14,8,33,6,0,17/18
Martin Olsson,se SWE,DF,Swansea City,29,1988,35,34,26,18,10,6,12,29,41.4,17,21,4,17,31,65,81,0,17/18
Divock Origi,be BEL,FW,Liverpool,22,1995,0.1,0,0,0,0,0,0,0,,0,0,0,0,0,0,0,0,17/18
David Ospina,co COL,GK,Arsenal,28,1988,4.2,0,0,0,0,0,0,0,,0,0,0,0,0,0,1,0,17/18
Nicolás Otamendi,ar ARG,DF,Manchester City,29,1988,33,58,43,35,22,1,19,44,43.2,25,21,10,11,48,106,129,3,17/18
Reece Oxford,eng ENG,MF,West Ham,18,1998,0.1,2,1,1,1,0,1,1,100,0,0,0,0,0,2,0,0,17/18
Alex Oxlade-Chamberlain,eng ENG,DF,Arsenal,23,1993,2.7,5,3,2,2,1,2,3,66.7,1,5,2,3,6,11,8,0,17/18
Alex Oxlade-Chamberlain,eng ENG,MFFW,Liverpool,23,1993,16.6,32,21,13,14,5,6,21,28.6,15,24,0,24,20,52,14,0,17/18
Mesut Özil,de GER,MFFW,Arsenal,28,1988,24,20,13,6,10,4,5,22,22.7,17,11,1,10,12,32,9,0,17/18
Kasey Palmer,jm JAM,MFFW,Huddersfield,20,1996,1.9,6,3,2,3,1,2,8,25,6,5,0,5,0,6,2,0,17/18
Emerson Palmieri,it ITA,DF,Chelsea,22,1994,3.1,6,4,4,2,0,5,5,100,0,2,0,2,2,8,10,0,17/18
Pedro,es ESP,MFFW,Chelsea,30,1987,16.9,20,11,6,8,6,5,18,27.8,13,13,1,12,13,33,7,1,17/18
Roberto Pereyra,ar ARG,MFFW,Watford,26,1991,18,10,8,4,5,1,2,13,15.4,11,16,0,16,9,19,6,0,17/18
Ayoze Pérez,es ESP,MFFW,Newcastle Utd,24,1993,27.7,39,21,11,15,13,12,54,22.2,42,36,1,35,24,63,28,0,17/18
Matt Phillips,sct SCO,MFDF,West Brom,26,1991,23.3,27,16,17,5,5,10,29,34.5,19,21,1,20,24,51,43,0,17/18
Jordan Pickford,eng ENG,GK,Everton,23,1994,38,0,0,0,0,0,0,2,0,2,0,0,0,2,2,26,5,17/18
Jérémy Pied,fr FRA,DF,Southampton,28,1989,2,9,6,8,1,0,6,9,66.7,3,3,2,1,8,17,4,0,17/18
Erik Pieters,nl NED,DF,Stoke City,28,1988,30.2,71,47,43,26,2,24,51,47.1,27,70,25,45,61,132,127,5,17/18
Paul Pogba,fr FRA,MF,Manchester Utd,24,1993,23.9,33,23,13,15,5,5,33,15.2,28,16,0,16,21,54,26,0,17/18
Nick Pope,eng ENG,GK,Burnley,25,1992,34.6,0,0,0,0,0,0,1,0,1,0,0,0,0,0,21,0,17/18
Alex Pritchard,eng ENG,MFFW,Huddersfield,24,1993,11.1,18,8,2,6,10,10,21,47.6,11,6,1,5,5,23,11,0,17/18
Sebastian Prödl,at AUT,DF,Watford,30,1987,17.4,22,17,19,3,0,8,15,53.3,7,20,9,11,31,53,92,1,17/18
Davy Pröpper,nl NED,MF,Brighton,25,1991,34.7,73,44,35,35,3,18,83,21.7,65,35,11,24,60,133,80,2,17/18
Marc Pugh,eng ENG,MFFW,Bournemouth,30,1987,10.9,7,3,2,4,1,2,10,20,8,6,1,5,13,20,13,2,17/18
Jason Puncheon,eng ENG,MF,Crystal Palace,31,1986,7.2,13,4,3,7,3,1,5,20,4,3,0,3,5,18,4,0,17/18
Collin Quaner,de GER,FWMF,Huddersfield,26,1991,14.2,22,15,8,8,6,9,26,34.6,17,24,4,20,11,33,15,0,17/18
Sandro Ramírez,es ESP,FWMF,Everton,22,1995,3.1,2,1,0,1,1,0,3,0,3,1,0,1,1,3,0,0,17/18
Aaron Ramsey,wls WAL,MF,Arsenal,26,1990,20.5,35,27,18,17,0,8,44,18.2,36,14,3,11,24,59,6,1,17/18
Àngel Rangel,es ESP,DF,Swansea City,34,1982,1.7,4,3,2,2,0,1,3,33.3,2,0,0,0,3,7,4,0,17/18
Marcus Rashford,eng ENG,FWMF,Manchester Utd,19,1997,20.1,14,11,4,5,5,6,18,33.3,12,18,0,18,8,22,19,0,17/18
Nathan Redmond,eng ENG,FWMF,Southampton,23,1994,21.6,32,17,16,14,2,12,31,38.7,19,20,0,20,15,47,17,2,17/18
Winston Reid,nz NZL,DF,West Ham,29,1988,16.1,11,9,7,4,0,4,15,26.7,11,27,14,13,22,33,104,0,17/18
Declan Rice,eng ENG,DFMF,West Ham,18,1999,15.9,36,24,25,10,1,15,25,60,10,19,13,6,27,63,77,1,17/18
Richarlison,br BRA,FWMF,Watford,20,1997,31.4,64,44,26,28,10,10,39,25.6,29,39,5,34,24,88,32,1,17/18
Jaïro Riedewald,nl NED,MFDF,Crystal Palace,20,1996,4.9,11,8,6,4,1,0,2,0,2,7,1,6,12,23,13,0,17/18
Matt Ritchie,sct SCO,MFFW,Newcastle Utd,27,1989,31.2,46,32,22,18,6,14,53,26.4,39,37,5,32,35,81,63,1,17/18
Connor Roberts,wls WAL,DF,Swansea City,21,1995,3,6,4,5,1,0,3,3,100,0,2,0,2,3,9,6,0,17/18
Andrew Robertson,sct SCO,DF,Liverpool,23,1994,21.6,31,17,19,9,3,15,29,51.7,14,22,2,20,26,57,56,0,17/18
Hal Robson-Kanu,wls WAL,FWMF,West Brom,28,1989,9.2,5,4,1,2,2,0,13,0,13,9,3,6,4,9,9,0,17/18
Jay Rodriguez,eng ENG,FWMF,West Brom,28,1989,31.2,31,21,12,11,8,9,50,18,41,32,2,30,19,50,41,0,17/18
Marcos Rojo,ar ARG,DF,Manchester Utd,27,1990,7.1,7,5,6,0,1,1,8,12.5,7,11,6,5,7,14,56,2,17/18
Sergio Romero,ar ARG,GK,Manchester Utd,30,1987,1,0,0,0,0,0,0,0,,0,0,0,0,0,0,0,0,17/18
Oriol Romeu,es ESP,MF,Southampton,25,1991,32.2,93,64,41,44,8,32,100,32,68,59,19,40,69,162,77,2,17/18
Salomón Rondón,ve VEN,FW,West Brom,27,1989,30.7,14,6,0,7,7,5,26,19.2,21,27,0,27,14,28,20,0,17/18
Wayne Rooney,eng ENG,MFFW,Everton,31,1985,25.2,28,19,11,13,4,10,42,23.8,32,25,6,19,16,44,43,2,17/18
Danny Rose,eng ENG,DF,Tottenham,27,1990,8.9,15,11,6,7,2,8,15,53.3,7,12,6,6,9,24,15,0,17/18
Liam Rosenior,eng ENG,DF,Brighton,33,1984,1.8,4,3,2,1,1,2,5,40,3,2,1,1,4,8,7,0,17/18
Wayne Routledge,eng ENG,MFFW,Swansea City,32,1985,4.8,10,5,2,6,2,2,8,25,6,5,0,5,2,12,5,0,17/18
Antonio Rüdiger,de GER,DF,Chelsea,24,1993,26,31,21,20,10,1,15,31,48.4,16,29,15,14,24,55,115,1,17/18
Mathew Ryan,au AUS,GK,Brighton,25,1992,38,0,0,0,0,0,0,3,0,3,0,0,0,3,3,10,3,17/18
Abdelhamid Sabiri,ma MAR,MF,Huddersfield,20,1996,2.4,5,4,2,0,3,1,7,14.3,6,4,0,4,1,6,2,0,17/18
Henri Saivet,sn SEN,MF,Newcastle Utd,26,1990,0.9,5,3,4,1,0,2,5,40,3,0,0,0,4,9,8,1,17/18
Diafra Sakho,sn SEN,FW,West Ham,27,1989,3.4,5,2,1,4,0,0,3,0,3,3,0,3,1,6,2,0,17/18
Mamadou Sakho,fr FRA,DF,Crystal Palace,27,1990,17.8,21,14,15,5,1,9,16,56.3,7,19,11,8,30,51,101,3,17/18
Bakary Sako,ml MLI,FWMF,Crystal Palace,29,1988,5.3,7,6,5,0,2,2,9,22.2,7,2,0,2,1,8,2,0,17/18
Mohamed Salah,eg EGY,FW,Liverpool,25,1992,32.3,12,6,2,5,5,3,23,13,20,10,0,10,5,17,5,0,17/18
Renato Sanches,pt POR,MF,Swansea City,19,1997,7.8,12,7,6,6,0,6,18,33.3,12,9,1,8,7,19,5,1,17/18
Alexis Sánchez,cl CHI,MFFW,Arsenal,28,1988,16.7,20,9,9,4,7,7,32,21.9,25,5,2,3,6,26,1,0,17/18
Alexis Sánchez,cl CHI,FWMF,Manchester Utd,28,1988,11.6,21,17,10,4,7,4,27,14.8,23,8,0,8,17,38,0,0,17/18
Davinson Sánchez,co COL,DF,Tottenham,21,1996,28.2,38,24,28,9,1,18,40,45,22,26,10,16,38,76,162,0,17/18
Leroy Sané,de GER,FW,Manchester City,21,1996,26.9,27,21,14,7,6,8,22,36.4,14,22,1,21,13,40,6,0,17/18
Ezequiel Schelotto,it ITA,DF,Brighton,28,1989,14.6,20,13,14,6,0,12,27,44.4,15,7,3,4,19,39,58,2,17/18
Christopher Schindler,de GER,DF,Huddersfield,27,1990,36.3,83,61,56,27,0,24,41,58.5,17,54,30,24,75,158,275,1,17/18
Jeffrey Schlupp,gh GHA,DFMF,Crystal Palace,24,1992,19.4,57,36,35,20,2,23,43,53.5,20,34,8,26,24,81,67,0,17/18
Kasper Schmeichel,dk DEN,GK,Leicester City,30,1986,32.9,1,0,1,0,0,1,3,33.3,2,1,0,1,0,1,18,5,17/18
Morgan Schneiderlin,fr FRA,MF,Everton,27,1989,23.7,58,40,34,21,3,15,44,34.1,29,18,7,11,61,119,59,1,17/18
Xherdan Shaqiri,ch SUI,MFFW,Stoke City,25,1991,33.8,25,17,9,11,5,10,39,25.6,29,9,1,8,16,41,6,2,17/18
Luke Shaw,eng ENG,DF,Manchester Utd,22,1995,8.8,18,15,10,7,1,11,18,61.1,7,16,2,14,4,22,22,1,17/18
Ryan Shawcross,eng ENG,DF,Stoke City,29,1987,26.3,36,20,25,9,2,13,25,52,12,33,23,10,40,76,224,1,17/18
Jonjo Shelvey,eng ENG,MF,Newcastle Utd,25,1992,25.2,39,24,17,21,1,8,26,30.8,18,26,5,21,28,67,33,0,17/18
Gylfi Sigurðsson,is ISL,MFFW,Everton,27,1989,25.1,38,26,15,14,9,16,57,28.1,41,37,7,30,34,72,36,0,17/18
Adrien Silva,pt POR,MF,Leicester City,28,1989,8.5,22,13,8,13,1,6,28,21.4,22,12,2,10,14,36,0,0,17/18
Bernardo Silva,pt POR,FWMF,Manchester City,22,1994,17,27,18,11,9,7,6,30,20,24,17,1,16,10,37,12,1,17/18
David Silva,es ESP,MF,Manchester City,31,1986,27,32,21,11,17,4,9,45,20,36,28,5,23,18,50,7,0,17/18
Danny Simpson,eng ENG,DF,Leicester City,30,1987,25.6,38,22,31,6,1,22,45,48.9,23,31,19,12,34,72,132,1,17/18
Jack Simpson,eng ENG,DF,Bournemouth,20,1996,0.8,1,1,1,0,0,0,1,0,1,1,0,1,0,1,4,0,17/18
Josh Sims,eng ENG,FWMF,Southampton,20,1997,1.8,4,3,1,2,1,2,7,28.6,5,5,0,5,1,5,0,0,17/18
Jerome Sinclair,eng ENG,MFFW,Watford,20,1996,0.3,0,0,0,0,0,0,1,0,1,0,0,0,1,1,0,0,17/18
Moussa Sissoko,fr FRA,MFFW,Tottenham,27,1989,15.4,23,17,14,5,4,9,12,75,3,11,1,10,9,32,23,1,17/18
Islam Slimani,dz ALG,FW,Leicester City,29,1988,2.8,2,2,1,1,0,1,4,25,3,2,0,2,0,2,2,0,17/18
Islam Slimani,dz ALG,FW,Newcastle Utd,29,1988,1.5,0,0,0,0,0,0,2,0,2,0,0,0,1,1,1,0,17/18
Chris Smalling,eng ENG,DF,Manchester Utd,27,1989,28.2,40,25,28,12,0,16,28,57.1,12,32,28,4,63,103,162,1,17/18
Adam Smith,eng ENG,DFMF,Bournemouth,26,1991,23,50,36,33,16,1,24,53,45.3,29,46,8,38,31,81,73,0,17/18
Tommy Smith,eng ENG,DF,Huddersfield,25,1992,21.2,38,27,18,14,6,23,36,63.9,13,22,6,16,26,64,80,3,17/18
Cédric Soares,pt POR,DF,Southampton,25,1991,31,54,34,40,10,4,22,31,71,9,32,8,24,24,78,109,2,17/18
Ramadan Sobhi,eg EGY,MFFW,Stoke City,20,1997,13.8,32,21,17,14,1,11,36,30.6,25,14,0,14,14,46,14,0,17/18
Dominic Solanke,eng ENG,FW,Liverpool,19,1997,6.6,7,4,0,6,1,1,4,25,3,5,1,4,2,9,9,0,17/18
Pape Souaré,sn SEN,DF,Crystal Palace,27,1990,0.1,0,0,0,0,0,0,0,,0,0,0,0,0,0,0,0,17/18
Julián Speroni,ar ARG,GK,Crystal Palace,38,1979,11,0,0,0,0,0,0,0,,0,0,0,0,1,1,4,0,17/18
Kostas Stafylidis,gr GRE,DFMF,Stoke City,23,1993,3.7,12,6,6,4,2,6,9,66.7,3,7,2,5,5,17,19,0,17/18
Junior Stanislas,eng ENG,MFFW,Bournemouth,27,1989,14.3,16,8,8,4,4,7,15,46.7,8,21,6,15,6,22,15,0,17/18
Dale Stephens,eng ENG,MF,Brighton,28,1989,36,104,62,63,39,2,32,114,28.1,82,53,16,37,63,167,69,1,17/18
Jack Stephens,eng ENG,DF,Southampton,23,1994,22,29,20,24,5,0,13,25,52,12,30,18,12,41,70,108,2,17/18
Raheem Sterling,eng ENG,FW,Manchester City,22,1994,28.7,19,14,7,7,5,3,32,9.4,29,24,0,24,9,28,9,0,17/18
John Stones,eng ENG,DF,Manchester City,23,1994,14.5,15,11,11,4,0,4,11,36.4,7,8,5,3,19,34,44,0,17/18
Daniel Sturridge,eng ENG,FW,West Brom,27,1989,1.3,0,0,0,0,0,0,0,,0,0,0,0,0,0,0,0,17/18
Daniel Sturridge,eng ENG,FW,Liverpool,27,1989,4.8,0,0,0,0,0,0,1,0,1,1,0,1,0,0,1,0,17/18
Ki Sung-yueng,kr KOR,MF,Swansea City,28,1989,20.8,25,18,10,13,2,4,16,25,12,16,1,15,32,57,23,0,17/18
Andrew Surman,eng ENG,MF,Bournemouth,30,1986,20.6,16,12,5,8,3,6,23,26.1,17,33,12,21,16,32,52,2,17/18
Markus Suttner,at AUT,DF,Brighton,30,1987,13.1,25,15,18,4,3,10,22,45.5,12,16,2,14,12,37,49,1,17/18
Lasse Sørensen,dk DEN,MF,Stoke City,17,1999,0.8,2,2,2,0,0,1,5,20,4,2,0,2,0,2,3,0,17/18
Alexander Sørloth,no NOR,FW,Crystal Palace,21,1995,4,6,3,1,4,1,4,12,33.3,8,5,0,5,2,8,5,0,17/18
Dušan Tadić,rs SRB,MFFW,Southampton,28,1988,31,46,29,16,22,8,11,35,31.4,24,38,2,36,19,65,29,1,17/18
Matt Targett,eng ENG,DF,Southampton,21,1995,1.8,6,3,5,0,1,1,3,33.3,2,3,2,1,3,9,7,1,17/18
James Tarkowski,eng ENG,DF,Burnley,24,1992,31,46,26,36,10,0,17,38,44.7,21,55,43,12,50,96,223,2,17/18
Charlie Taylor,eng ENG,DF,Burnley,23,1993,10.6,16,4,9,6,1,7,12,58.3,5,13,5,8,15,31,52,0,17/18
James Tomkins,eng ENG,DF,Crystal Palace,28,1989,26.5,47,26,36,10,1,16,31,51.6,15,24,12,12,63,110,216,1,17/18
Cenk Tosun,tr TUR,FW,Everton,26,1991,11,6,3,2,2,2,1,11,9.1,10,9,4,5,1,7,13,0,17/18
Yaya Touré,ci CIV,MF,Manchester City,34,1983,2.6,2,2,1,0,1,1,1,100,0,3,1,2,5,7,4,0,17/18
Andros Townsend,eng ENG,FWMF,Crystal Palace,26,1991,34.7,60,34,35,12,13,24,75,32,51,49,1,48,35,95,28,0,17/18
Kieran Trippier,eng ENG,DF,Tottenham,26,1990,21.3,52,30,29,21,2,21,44,47.7,23,31,6,25,20,72,53,1,17/18
Axel Tuanzebe,eng ENG,FW,Manchester Utd,19,1997,0,0,0,0,0,0,0,0,,0,0,0,0,0,0,0,0,17/18
Josh Tymon,eng ENG,DF,Stoke City,18,1999,1.8,5,1,4,1,0,2,3,66.7,1,1,0,1,1,6,3,0,17/18
Leonardo Ulloa,ar ARG,FW,Leicester City,31,1986,0.2,1,0,0,0,1,0,0,,0,0,0,0,0,1,1,0,17/18
Leonardo Ulloa,ar ARG,FW,Brighton,31,1986,3,3,1,0,1,2,1,7,14.3,6,1,0,1,0,3,3,0,17/18
Antonio Valencia,ec ECU,DF,Manchester Utd,31,1985,30.4,57,32,21,28,8,16,36,44.4,20,47,6,41,48,105,80,0,17/18
Virgil van Dijk,nl NED,DF,Southampton,26,1991,11,10,7,6,2,2,2,3,66.7,1,14,13,1,29,39,81,1,17/18
Virgil van Dijk,nl NED,DF,Liverpool,26,1991,14,15,8,7,7,1,4,5,80,1,8,2,6,18,33,80,1,17/18
Jamie Vardy,eng ENG,FW,Leicester City,30,1987,36.1,15,9,3,7,5,1,8,12.5,7,21,1,20,2,17,17,0,17/18
Jan Vertonghen,be BEL,DF,Tottenham,30,1987,35.6,64,41,40,20,4,25,36,69.4,11,29,11,18,60,124,177,0,17/18
Nikola Vlašić,hr CRO,MFFW,Everton,19,1997,6.4,9,5,3,6,0,2,9,22.2,7,14,2,12,9,18,10,0,17/18
Sam Vokes,wls WAL,FW,Burnley,27,1989,11.1,3,1,1,2,0,0,3,0,3,6,2,4,3,6,15,0,17/18
Michel Vorm,nl NED,GK,Tottenham,33,1983,1,0,0,0,0,0,0,0,,0,0,0,0,0,0,1,0,17/18
Molla Wagué,ml MLI,DF,Watford,26,1991,4.9,5,3,3,2,0,2,5,40,3,1,0,1,9,14,30,0,17/18
Theo Walcott,eng ENG,FWMF,Arsenal,28,1989,0.8,1,0,1,0,0,0,0,,0,0,0,0,1,2,0,0,17/18
Theo Walcott,eng ENG,FW,Everton,28,1989,12.8,27,19,12,13,2,7,15,46.7,8,9,0,9,8,35,12,0,17/18
Kyle Walker,eng ENG,DF,Manchester City,27,1990,30.9,47,31,20,21,6,18,31,58.1,13,21,2,19,29,76,75,2,17/18
Kyle Walker-Peters,eng ENG,DF,Tottenham,20,1997,2.1,5,4,4,1,0,2,4,50,2,2,0,2,3,8,8,0,17/18
Jonathan Walters,ie IRL,FW,Burnley,33,1983,0.4,0,0,0,0,0,0,0,,0,0,0,0,0,0,1,0,17/18
Aaron Wan-Bissaka,eng ENG,DF,Crystal Palace,19,1997,7,30,19,20,7,3,15,19,78.9,4,18,7,11,15,45,45,0,17/18
Victor Wanyama,ke KEN,MF,Tottenham,26,1991,9.4,30,20,13,16,1,14,31,45.2,17,13,3,10,10,40,20,1,17/18
Joel Ward,eng ENG,DF,Crystal Palace,27,1989,17.9,35,30,23,12,0,16,28,57.1,12,27,11,16,28,63,76,0,17/18
Stephen Ward,ie IRL,DF,Burnley,31,1985,27.3,39,31,27,8,4,20,42,47.6,22,27,12,15,42,81,126,0,17/18
James Ward-Prowse,eng ENG,FWMF,Southampton,22,1994,19.1,23,16,9,11,3,3,27,11.1,24,29,1,28,8,31,31,0,17/18
Ben Watson,eng ENG,MF,Watford,32,1985,5.1,19,9,9,9,1,10,31,32.3,21,6,1,5,7,26,10,0,17/18
Danny Welbeck,eng ENG,FWMF,Arsenal,26,1990,13.3,20,13,9,5,6,4,12,33.3,8,22,1,21,11,31,13,0,17/18
Nahki Wells,bm BER,FWMF,Burnley,27,1990,0.6,4,3,0,3,1,1,1,100,0,2,0,2,0,4,0,0,17/18
Ashley Westwood,eng ENG,MF,Burnley,27,1990,12.3,13,10,10,3,0,2,16,12.5,14,17,9,8,19,32,16,0,17/18
Dean Whitehead,eng ENG,MF,Huddersfield,35,1982,0.8,0,0,0,0,0,0,1,0,1,1,0,1,2,2,0,0,17/18
Georginio Wijnaldum,nl NED,MF,Liverpool,26,1990,26.5,34,23,13,16,5,11,23,47.8,12,20,2,18,25,59,20,0,17/18
Ashley Williams,wls WAL,DF,Everton,32,1984,20.4,23,13,17,6,0,9,18,50,9,31,23,8,36,59,173,3,17/18
Danny Williams,us USA,MF,Huddersfield,28,1989,12.5,23,14,13,9,1,7,22,31.8,15,12,2,10,26,49,27,0,17/18
Willian,br BRA,MFFW,Chelsea,28,1988,21,22,17,7,12,3,0,16,0,16,13,1,12,10,32,10,0,17/18
Joe Willock,eng ENG,MF,Arsenal,17,1999,0.9,4,2,4,0,0,1,1,100,0,3,0,3,1,5,2,0,17/18
Jack Wilshere,eng ENG,MF,Arsenal,25,1992,13.3,15,10,3,7,5,4,20,20,16,10,2,8,8,23,5,0,17/18
Callum Wilson,eng ENG,FW,Bournemouth,25,1992,22,9,5,2,6,1,1,14,7.1,13,15,3,12,3,12,15,0,17/18
Kevin Wimmer,at AUT,DF,Stoke City,24,1992,14.7,24,17,17,7,0,9,20,45,11,25,12,13,30,54,88,0,17/18
Harry Winks,eng ENG,MF,Tottenham,21,1996,8.6,15,12,8,5,2,8,16,50,8,12,2,10,11,26,10,1,17/18
Chris Wood,nz NZL,FW,Burnley,25,1991,18,7,3,2,3,2,3,13,23.1,10,12,4,8,0,7,16,0,17/18
Ben Woodburn,wls WAL,FW,Liverpool,17,1999,0.1,0,0,0,0,0,0,0,,0,0,0,0,0,0,0,0,17/18
Granit Xhaka,ch SUI,MF,Arsenal,24,1992,36.2,78,57,35,40,3,26,69,37.7,43,30,9,21,37,115,68,4,17/18
Claudio Yacob,ar ARG,MF,West Brom,30,1987,10,36,27,23,13,0,13,27,48.1,14,14,6,8,16,52,25,2,17/18
DeAndre Yedlin,us USA,DF,Newcastle Utd,24,1993,31.6,57,33,39,14,4,26,54,48.1,28,37,7,30,44,101,114,0,17/18
Maya Yoshida,jp JPN,DF,Southampton,28,1988,22.8,27,20,22,5,0,18,25,72,7,32,14,18,41,68,133,2,17/18
Ashley Young,eng ENG,DF,Manchester Utd,32,1985,27.1,53,32,30,17,6,18,47,38.3,29,24,5,19,57,110,86,1,17/18
Pablo Zabaleta,ar ARG,DFMF,West Ham,32,1985,36.5,96,67,54,28,14,48,98,49,50,72,13,59,61,157,152,0,17/18
Wilfried Zaha,ci CIV,FWMF,Crystal Palace,24,1992,28.3,30,23,9,13,8,4,23,17.4,19,24,0,24,7,37,4,0,17/18
Davide Zappacosta,it ITA,DFMF,Chelsea,25,1992,12.2,26,11,14,9,3,11,25,44,14,11,2,9,6,32,26,0,17/18
Marvin Zeegelaar,nl NED,DF,Watford,26,1990,11,23,18,15,3,5,11,24,45.8,13,5,1,4,20,43,30,0,17/18
Oleksandr Zinchenko,ua UKR,DF,Manchester City,20,1996,5.9,23,16,11,9,3,7,13,53.8,6,3,0,3,6,29,7,0,17/18
Kurt Zouma,fr FRA,DF,Stoke City,22,1994,32.1,50,38,35,13,2,21,28,75,7,42,23,19,61,111,246,2,17/18